last_obs_season,last_obs_week,h,target_season,target_week,target_total_cases,predicted_total_cases,predictive_ae,predictive_log_score
2004/2005,10,43,2005/2006,1,4,10,6,-Inf
2004/2005,10,44,2005/2006,2,2,7,5,-Inf
2004/2005,10,45,2005/2006,3,6,5,1,-10.819778284410283
2004/2005,10,46,2005/2006,4,3,3,0,-0.34426653338715596
2004/2005,10,47,2005/2006,5,4,12,8,-Inf
2004/2005,10,48,2005/2006,6,10,13,3,-11.512925464970229
2004/2005,10,49,2005/2006,7,12,10,2,-Inf
2004/2005,10,50,2005/2006,8,21,13,8,-11.512925464970229
2004/2005,10,51,2005/2006,9,26,13,13,-Inf
2004/2005,10,52,2005/2006,10,21,8,13,-Inf
2004/2005,11,42,2005/2006,1,4,10,6,-Inf
2004/2005,11,43,2005/2006,2,2,7,5,-10.819778284410283
2004/2005,11,44,2005/2006,3,6,5,1,-10.41431317630212
2004/2005,11,45,2005/2006,4,3,3,0,-0.33935438602645185
2004/2005,11,46,2005/2006,5,4,12,8,-Inf
2004/2005,11,47,2005/2006,6,10,13,3,-Inf
2004/2005,11,48,2005/2006,7,12,10,2,-Inf
2004/2005,11,49,2005/2006,8,21,13,8,-Inf
2004/2005,11,50,2005/2006,9,26,13,13,-Inf
2004/2005,11,51,2005/2006,10,21,8,13,-Inf
2004/2005,11,52,2005/2006,11,30,21,9,-Inf
2004/2005,12,41,2005/2006,1,4,10,6,-Inf
2004/2005,12,42,2005/2006,2,2,7,5,-Inf
2004/2005,12,43,2005/2006,3,6,5,1,-10.819778284410283
2004/2005,12,44,2005/2006,4,3,3,0,-0.33970545785233064
2004/2005,12,45,2005/2006,5,4,12,8,-11.512925464970229
2004/2005,12,46,2005/2006,6,10,13,3,-Inf
2004/2005,12,47,2005/2006,7,12,10,2,-Inf
2004/2005,12,48,2005/2006,8,21,13,8,-Inf
2004/2005,12,49,2005/2006,9,26,13,13,-11.512925464970229
2004/2005,12,50,2005/2006,10,21,8,13,-Inf
2004/2005,12,51,2005/2006,11,30,21,9,-Inf
2004/2005,12,52,2005/2006,12,45,18,27,-Inf
2004/2005,13,40,2005/2006,1,4,10,6,-Inf
2004/2005,13,41,2005/2006,2,2,7,5,-Inf
2004/2005,13,42,2005/2006,3,6,5,1,-11.512925464970229
2004/2005,13,43,2005/2006,4,3,3,0,-0.34285657319643725
2004/2005,13,44,2005/2006,5,4,12,8,-Inf
2004/2005,13,45,2005/2006,6,10,13,3,-Inf
2004/2005,13,46,2005/2006,7,12,10,2,-Inf
2004/2005,13,47,2005/2006,8,21,13,8,-Inf
2004/2005,13,48,2005/2006,9,26,13,13,-Inf
2004/2005,13,49,2005/2006,10,21,8,13,-Inf
2004/2005,13,50,2005/2006,11,30,21,9,-11.512925464970229
2004/2005,13,51,2005/2006,12,45,18,27,-Inf
2004/2005,13,52,2005/2006,13,56,8,48,-Inf
2004/2005,14,39,2005/2006,1,4,10,6,-Inf
2004/2005,14,40,2005/2006,2,2,7,5,-Inf
2004/2005,14,41,2005/2006,3,6,5,1,-11.512925464970229
2004/2005,14,42,2005/2006,4,3,3,0,-0.34856506097535345
2004/2005,14,43,2005/2006,5,4,12,8,-Inf
2004/2005,14,44,2005/2006,6,10,13,3,-Inf
2004/2005,14,45,2005/2006,7,12,10,2,-Inf
2004/2005,14,46,2005/2006,8,21,13,8,-Inf
2004/2005,14,47,2005/2006,9,26,13,13,-Inf
2004/2005,14,48,2005/2006,10,21,8,13,-Inf
2004/2005,14,49,2005/2006,11,30,21,9,-Inf
2004/2005,14,50,2005/2006,12,45,18,27,-Inf
2004/2005,14,51,2005/2006,13,56,8,48,-Inf
2004/2005,14,52,2005/2006,14,75,7,68,-Inf
2004/2005,15,38,2005/2006,1,4,10,6,-Inf
2004/2005,15,39,2005/2006,2,2,7,5,-Inf
2004/2005,15,40,2005/2006,3,6,5,1,-Inf
2004/2005,15,41,2005/2006,4,3,3,0,-0.3517869098659574
2004/2005,15,42,2005/2006,5,4,12,8,-Inf
2004/2005,15,43,2005/2006,6,10,13,3,-Inf
2004/2005,15,44,2005/2006,7,12,10,2,-Inf
2004/2005,15,45,2005/2006,8,21,13,8,-Inf
2004/2005,15,46,2005/2006,9,26,13,13,-11.512925464970229
2004/2005,15,47,2005/2006,10,21,8,13,-11.512925464970229
2004/2005,15,48,2005/2006,11,30,21,9,-Inf
2004/2005,15,49,2005/2006,12,45,18,27,-Inf
2004/2005,15,50,2005/2006,13,56,8,48,-Inf
2004/2005,15,51,2005/2006,14,75,7,68,-Inf
2004/2005,15,52,2005/2006,15,83,20,63,-Inf
2004/2005,16,37,2005/2006,1,4,10,6,-Inf
2004/2005,16,38,2005/2006,2,2,7,5,-Inf
2004/2005,16,39,2005/2006,3,6,5,1,-11.512925464970229
2004/2005,16,40,2005/2006,4,3,3,0,-0.355632630193627
2004/2005,16,41,2005/2006,5,4,12,8,-Inf
2004/2005,16,42,2005/2006,6,10,13,3,-11.512925464970229
2004/2005,16,43,2005/2006,7,12,10,2,-11.512925464970229
2004/2005,16,44,2005/2006,8,21,13,8,-11.512925464970229
2004/2005,16,45,2005/2006,9,26,13,13,-Inf
2004/2005,16,46,2005/2006,10,21,8,13,-Inf
2004/2005,16,47,2005/2006,11,30,21,9,-Inf
2004/2005,16,48,2005/2006,12,45,18,27,-Inf
2004/2005,16,49,2005/2006,13,56,8,48,-Inf
2004/2005,16,50,2005/2006,14,75,7,68,-Inf
2004/2005,16,51,2005/2006,15,83,20,63,-Inf
2004/2005,16,52,2005/2006,16,82,14,68,-Inf
2004/2005,17,36,2005/2006,1,4,10,6,-Inf
2004/2005,17,37,2005/2006,2,2,7,5,-Inf
2004/2005,17,38,2005/2006,3,6,5,1,-Inf
2004/2005,17,39,2005/2006,4,3,3,0,-0.35841932162408163
2004/2005,17,40,2005/2006,5,4,12,8,-Inf
2004/2005,17,41,2005/2006,6,10,13,3,-Inf
2004/2005,17,42,2005/2006,7,12,10,2,-Inf
2004/2005,17,43,2005/2006,8,21,13,8,-Inf
2004/2005,17,44,2005/2006,9,26,13,13,-Inf
2004/2005,17,45,2005/2006,10,21,8,13,-Inf
2004/2005,17,46,2005/2006,11,30,21,9,-Inf
2004/2005,17,47,2005/2006,12,45,18,27,-Inf
2004/2005,17,48,2005/2006,13,56,8,48,-Inf
2004/2005,17,49,2005/2006,14,75,7,68,-Inf
2004/2005,17,50,2005/2006,15,83,20,63,-Inf
2004/2005,17,51,2005/2006,16,82,14,68,-Inf
2004/2005,17,52,2005/2006,17,126,14,112,-Inf
2004/2005,18,35,2005/2006,1,4,10,6,-Inf
2004/2005,18,36,2005/2006,2,2,7,5,-11.512925464970229
2004/2005,18,37,2005/2006,3,6,5,1,-Inf
2004/2005,18,38,2005/2006,4,3,3,0,-0.3587485208856407
2004/2005,18,39,2005/2006,5,4,12,8,-11.512925464970229
2004/2005,18,40,2005/2006,6,10,13,3,-Inf
2004/2005,18,41,2005/2006,7,12,10,2,-Inf
2004/2005,18,42,2005/2006,8,21,13,8,-11.512925464970229
2004/2005,18,43,2005/2006,9,26,13,13,-Inf
2004/2005,18,44,2005/2006,10,21,8,13,-11.512925464970229
2004/2005,18,45,2005/2006,11,30,21,9,-Inf
2004/2005,18,46,2005/2006,12,45,18,27,-Inf
2004/2005,18,47,2005/2006,13,56,8,48,-11.512925464970229
2004/2005,18,48,2005/2006,14,75,7,68,-Inf
2004/2005,18,49,2005/2006,15,83,20,63,-Inf
2004/2005,18,50,2005/2006,16,82,14,68,-Inf
2004/2005,18,51,2005/2006,17,126,14,112,-Inf
2004/2005,18,52,2005/2006,18,119,7,112,-Inf
2004/2005,19,34,2005/2006,1,4,10,6,-11.512925464970229
2004/2005,19,35,2005/2006,2,2,7,5,-Inf
2004/2005,19,36,2005/2006,3,6,5,1,-Inf
2004/2005,19,37,2005/2006,4,3,3,0,-0.3607546833411064
2004/2005,19,38,2005/2006,5,4,12,8,-11.512925464970229
2004/2005,19,39,2005/2006,6,10,13,3,-Inf
2004/2005,19,40,2005/2006,7,12,10,2,-11.512925464970229
2004/2005,19,41,2005/2006,8,21,13,8,-Inf
2004/2005,19,42,2005/2006,9,26,13,13,-Inf
2004/2005,19,43,2005/2006,10,21,8,13,-Inf
2004/2005,19,44,2005/2006,11,30,21,9,-Inf
2004/2005,19,45,2005/2006,12,45,18,27,-Inf
2004/2005,19,46,2005/2006,13,56,8,48,-Inf
2004/2005,19,47,2005/2006,14,75,7,68,-Inf
2004/2005,19,48,2005/2006,15,83,20,63,-Inf
2004/2005,19,49,2005/2006,16,82,14,68,-Inf
2004/2005,19,50,2005/2006,17,126,14,112,-Inf
2004/2005,19,51,2005/2006,18,119,7,112,-Inf
2004/2005,19,52,2005/2006,19,137,14,123,-Inf
2004/2005,1,52,2005/2006,1,4,10,6,-Inf
2004/2005,20,33,2005/2006,1,4,10,6,-10.819778284410283
2004/2005,20,34,2005/2006,2,2,7,5,-Inf
2004/2005,20,35,2005/2006,3,6,5,1,-10.819778284410283
2004/2005,20,36,2005/2006,4,3,3,0,-0.3617018433671415
2004/2005,20,37,2005/2006,5,4,12,8,-Inf
2004/2005,20,38,2005/2006,6,10,13,3,-11.512925464970229
2004/2005,20,39,2005/2006,7,12,10,2,-11.512925464970229
2004/2005,20,40,2005/2006,8,21,13,8,-Inf
2004/2005,20,41,2005/2006,9,26,13,13,-Inf
2004/2005,20,42,2005/2006,10,21,8,13,-Inf
2004/2005,20,43,2005/2006,11,30,21,9,-Inf
2004/2005,20,44,2005/2006,12,45,18,27,-Inf
2004/2005,20,45,2005/2006,13,56,8,48,-Inf
2004/2005,20,46,2005/2006,14,75,7,68,-Inf
2004/2005,20,47,2005/2006,15,83,20,63,-Inf
2004/2005,20,48,2005/2006,16,82,14,68,-Inf
2004/2005,20,49,2005/2006,17,126,14,112,-Inf
2004/2005,20,50,2005/2006,18,119,7,112,-Inf
2004/2005,20,51,2005/2006,19,137,14,123,-Inf
2004/2005,20,52,2005/2006,20,131,10,121,-Inf
2004/2005,21,32,2005/2006,1,4,10,6,-11.512925464970229
2004/2005,21,33,2005/2006,2,2,7,5,-Inf
2004/2005,21,34,2005/2006,3,6,5,1,-11.512925464970229
2004/2005,21,35,2005/2006,4,3,3,0,-0.35886305038427047
2004/2005,21,36,2005/2006,5,4,12,8,-Inf
2004/2005,21,37,2005/2006,6,10,13,3,-10.819778284410283
2004/2005,21,38,2005/2006,7,12,10,2,-Inf
2004/2005,21,39,2005/2006,8,21,13,8,-Inf
2004/2005,21,40,2005/2006,9,26,13,13,-Inf
2004/2005,21,41,2005/2006,10,21,8,13,-Inf
2004/2005,21,42,2005/2006,11,30,21,9,-Inf
2004/2005,21,43,2005/2006,12,45,18,27,-Inf
2004/2005,21,44,2005/2006,13,56,8,48,-Inf
2004/2005,21,45,2005/2006,14,75,7,68,-Inf
2004/2005,21,46,2005/2006,15,83,20,63,-Inf
2004/2005,21,47,2005/2006,16,82,14,68,-Inf
2004/2005,21,48,2005/2006,17,126,14,112,-Inf
2004/2005,21,49,2005/2006,18,119,7,112,-Inf
2004/2005,21,50,2005/2006,19,137,14,123,-Inf
2004/2005,21,51,2005/2006,20,131,10,121,-Inf
2004/2005,21,52,2005/2006,21,112,13,99,-Inf
2004/2005,22,31,2005/2006,1,4,10,6,-Inf
2004/2005,22,32,2005/2006,2,2,7,5,-Inf
2004/2005,22,33,2005/2006,3,6,5,1,-11.512925464970229
2004/2005,22,34,2005/2006,4,3,3,0,-0.36538418811581863
2004/2005,22,35,2005/2006,5,4,12,8,-Inf
2004/2005,22,36,2005/2006,6,10,13,3,-11.512925464970229
2004/2005,22,37,2005/2006,7,12,10,2,-Inf
2004/2005,22,38,2005/2006,8,21,13,8,-Inf
2004/2005,22,39,2005/2006,9,26,13,13,-Inf
2004/2005,22,40,2005/2006,10,21,8,13,-Inf
2004/2005,22,41,2005/2006,11,30,21,9,-Inf
2004/2005,22,42,2005/2006,12,45,18,27,-Inf
2004/2005,22,43,2005/2006,13,56,8,48,-Inf
2004/2005,22,44,2005/2006,14,75,7,68,-Inf
2004/2005,22,45,2005/2006,15,83,20,63,-Inf
2004/2005,22,46,2005/2006,16,82,14,68,-Inf
2004/2005,22,47,2005/2006,17,126,14,112,-Inf
2004/2005,22,48,2005/2006,18,119,7,112,-Inf
2004/2005,22,49,2005/2006,19,137,14,123,-Inf
2004/2005,22,50,2005/2006,20,131,10,121,-Inf
2004/2005,22,51,2005/2006,21,112,13,99,-Inf
2004/2005,22,52,2005/2006,22,82,27,55,-Inf
2004/2005,23,30,2005/2006,1,4,10,6,-Inf
2004/2005,23,31,2005/2006,2,2,7,5,-Inf
2004/2005,23,32,2005/2006,3,6,5,1,-Inf
2004/2005,23,33,2005/2006,4,3,3,0,-0.3637283321280833
2004/2005,23,34,2005/2006,5,4,12,8,-Inf
2004/2005,23,35,2005/2006,6,10,13,3,-Inf
2004/2005,23,36,2005/2006,7,12,10,2,-Inf
2004/2005,23,37,2005/2006,8,21,13,8,-Inf
2004/2005,23,38,2005/2006,9,26,13,13,-Inf
2004/2005,23,39,2005/2006,10,21,8,13,-Inf
2004/2005,23,40,2005/2006,11,30,21,9,-Inf
2004/2005,23,41,2005/2006,12,45,18,27,-Inf
2004/2005,23,42,2005/2006,13,56,8,48,-Inf
2004/2005,23,43,2005/2006,14,75,7,68,-Inf
2004/2005,23,44,2005/2006,15,83,20,63,-Inf
2004/2005,23,45,2005/2006,16,82,14,68,-Inf
2004/2005,23,46,2005/2006,17,126,14,112,-Inf
2004/2005,23,47,2005/2006,18,119,7,112,-Inf
2004/2005,23,48,2005/2006,19,137,14,123,-Inf
2004/2005,23,49,2005/2006,20,131,10,121,-Inf
2004/2005,23,50,2005/2006,21,112,13,99,-Inf
2004/2005,23,51,2005/2006,22,82,27,55,-Inf
2004/2005,23,52,2005/2006,23,73,13,60,-Inf
2004/2005,24,29,2005/2006,1,4,10,6,-Inf
2004/2005,24,30,2005/2006,2,2,7,5,-Inf
2004/2005,24,31,2005/2006,3,6,5,1,-Inf
2004/2005,24,32,2005/2006,4,3,3,0,-0.3638865998166274
2004/2005,24,33,2005/2006,5,4,12,8,-Inf
2004/2005,24,34,2005/2006,6,10,13,3,-Inf
2004/2005,24,35,2005/2006,7,12,10,2,-Inf
2004/2005,24,36,2005/2006,8,21,13,8,-Inf
2004/2005,24,37,2005/2006,9,26,13,13,-Inf
2004/2005,24,38,2005/2006,10,21,8,13,-Inf
2004/2005,24,39,2005/2006,11,30,21,9,-11.512925464970229
2004/2005,24,40,2005/2006,12,45,18,27,-Inf
2004/2005,24,41,2005/2006,13,56,8,48,-Inf
2004/2005,24,42,2005/2006,14,75,7,68,-Inf
2004/2005,24,43,2005/2006,15,83,20,63,-11.512925464970229
2004/2005,24,44,2005/2006,16,82,14,68,-Inf
2004/2005,24,45,2005/2006,17,126,14,112,-Inf
2004/2005,24,46,2005/2006,18,119,7,112,-Inf
2004/2005,24,47,2005/2006,19,137,14,123,-Inf
2004/2005,24,48,2005/2006,20,131,10,121,-Inf
2004/2005,24,49,2005/2006,21,112,13,99,-Inf
2004/2005,24,50,2005/2006,22,82,27,55,-Inf
2004/2005,24,51,2005/2006,23,73,13,60,-Inf
2004/2005,24,52,2005/2006,24,43,18,25,-Inf
2004/2005,25,28,2005/2006,1,4,10,6,-Inf
2004/2005,25,29,2005/2006,2,2,7,5,-Inf
2004/2005,25,30,2005/2006,3,6,5,1,-Inf
2004/2005,25,31,2005/2006,4,3,3,0,-0.3639585479564378
2004/2005,25,32,2005/2006,5,4,12,8,-11.512925464970229
2004/2005,25,33,2005/2006,6,10,13,3,-11.512925464970229
2004/2005,25,34,2005/2006,7,12,10,2,-Inf
2004/2005,25,35,2005/2006,8,21,13,8,-Inf
2004/2005,25,36,2005/2006,9,26,13,13,-Inf
2004/2005,25,37,2005/2006,10,21,8,13,-Inf
2004/2005,25,38,2005/2006,11,30,21,9,-Inf
2004/2005,25,39,2005/2006,12,45,18,27,-Inf
2004/2005,25,40,2005/2006,13,56,8,48,-Inf
2004/2005,25,41,2005/2006,14,75,7,68,-Inf
2004/2005,25,42,2005/2006,15,83,20,63,-Inf
2004/2005,25,43,2005/2006,16,82,14,68,-Inf
2004/2005,25,44,2005/2006,17,126,14,112,-Inf
2004/2005,25,45,2005/2006,18,119,7,112,-Inf
2004/2005,25,46,2005/2006,19,137,14,123,-Inf
2004/2005,25,47,2005/2006,20,131,10,121,-Inf
2004/2005,25,48,2005/2006,21,112,13,99,-Inf
2004/2005,25,49,2005/2006,22,82,27,55,-Inf
2004/2005,25,50,2005/2006,23,73,13,60,-Inf
2004/2005,25,51,2005/2006,24,43,18,25,-Inf
2004/2005,25,52,2005/2006,25,55,16,39,-Inf
2004/2005,26,27,2005/2006,1,4,10,6,-Inf
2004/2005,26,28,2005/2006,2,2,7,5,-Inf
2004/2005,26,29,2005/2006,3,6,5,1,-11.512925464970229
2004/2005,26,30,2005/2006,4,3,3,0,-0.368747525173001
2004/2005,26,31,2005/2006,5,4,12,8,-11.512925464970229
2004/2005,26,32,2005/2006,6,10,13,3,-11.512925464970229
2004/2005,26,33,2005/2006,7,12,10,2,-Inf
2004/2005,26,34,2005/2006,8,21,13,8,-Inf
2004/2005,26,35,2005/2006,9,26,13,13,-11.512925464970229
2004/2005,26,36,2005/2006,10,21,8,13,-Inf
2004/2005,26,37,2005/2006,11,30,21,9,-Inf
2004/2005,26,38,2005/2006,12,45,18,27,-Inf
2004/2005,26,39,2005/2006,13,56,8,48,-Inf
2004/2005,26,40,2005/2006,14,75,7,68,-Inf
2004/2005,26,41,2005/2006,15,83,20,63,-Inf
2004/2005,26,42,2005/2006,16,82,14,68,-Inf
2004/2005,26,43,2005/2006,17,126,14,112,-Inf
2004/2005,26,44,2005/2006,18,119,7,112,-Inf
2004/2005,26,45,2005/2006,19,137,14,123,-Inf
2004/2005,26,46,2005/2006,20,131,10,121,-Inf
2004/2005,26,47,2005/2006,21,112,13,99,-Inf
2004/2005,26,48,2005/2006,22,82,27,55,-Inf
2004/2005,26,49,2005/2006,23,73,13,60,-Inf
2004/2005,26,50,2005/2006,24,43,18,25,-Inf
2004/2005,26,51,2005/2006,25,55,16,39,-Inf
2004/2005,26,52,2005/2006,26,55,16,39,-Inf
2004/2005,27,26,2005/2006,1,4,10,6,-11.512925464970229
2004/2005,27,27,2005/2006,2,2,7,5,-11.512925464970229
2004/2005,27,28,2005/2006,3,6,5,1,-10.819778284410283
2004/2005,27,29,2005/2006,4,3,3,0,-0.3680826219208342
2004/2005,27,30,2005/2006,5,4,12,8,-Inf
2004/2005,27,31,2005/2006,6,10,13,3,-Inf
2004/2005,27,32,2005/2006,7,12,10,2,-Inf
2004/2005,27,33,2005/2006,8,21,13,8,-Inf
2004/2005,27,34,2005/2006,9,26,13,13,-Inf
2004/2005,27,35,2005/2006,10,21,8,13,-11.512925464970229
2004/2005,27,36,2005/2006,11,30,21,9,-Inf
2004/2005,27,37,2005/2006,12,45,18,27,-Inf
2004/2005,27,38,2005/2006,13,56,8,48,-Inf
2004/2005,27,39,2005/2006,14,75,7,68,-Inf
2004/2005,27,40,2005/2006,15,83,20,63,-Inf
2004/2005,27,41,2005/2006,16,82,14,68,-Inf
2004/2005,27,42,2005/2006,17,126,14,112,-Inf
2004/2005,27,43,2005/2006,18,119,7,112,-Inf
2004/2005,27,44,2005/2006,19,137,14,123,-Inf
2004/2005,27,45,2005/2006,20,131,10,121,-Inf
2004/2005,27,46,2005/2006,21,112,13,99,-Inf
2004/2005,27,47,2005/2006,22,82,27,55,-Inf
2004/2005,27,48,2005/2006,23,73,13,60,-Inf
2004/2005,27,49,2005/2006,24,43,18,25,-Inf
2004/2005,27,50,2005/2006,25,55,16,39,-Inf
2004/2005,27,51,2005/2006,26,55,16,39,-Inf
2004/2005,27,52,2005/2006,27,53,20,33,-Inf
2004/2005,28,25,2005/2006,1,4,10,6,-Inf
2004/2005,28,26,2005/2006,2,2,7,5,-Inf
2004/2005,28,27,2005/2006,3,6,5,1,-10.819778284410283
2004/2005,28,28,2005/2006,4,3,3,0,-0.36838610986674425
2004/2005,28,29,2005/2006,5,4,12,8,-Inf
2004/2005,28,30,2005/2006,6,10,13,3,-Inf
2004/2005,28,31,2005/2006,7,12,10,2,-11.512925464970229
2004/2005,28,32,2005/2006,8,21,13,8,-Inf
2004/2005,28,33,2005/2006,9,26,13,13,-Inf
2004/2005,28,34,2005/2006,10,21,8,13,-Inf
2004/2005,28,35,2005/2006,11,30,21,9,-Inf
2004/2005,28,36,2005/2006,12,45,18,27,-Inf
2004/2005,28,37,2005/2006,13,56,8,48,-Inf
2004/2005,28,38,2005/2006,14,75,7,68,-Inf
2004/2005,28,39,2005/2006,15,83,20,63,-Inf
2004/2005,28,40,2005/2006,16,82,14,68,-Inf
2004/2005,28,41,2005/2006,17,126,14,112,-Inf
2004/2005,28,42,2005/2006,18,119,7,112,-Inf
2004/2005,28,43,2005/2006,19,137,14,123,-Inf
2004/2005,28,44,2005/2006,20,131,10,121,-Inf
2004/2005,28,45,2005/2006,21,112,13,99,-Inf
2004/2005,28,46,2005/2006,22,82,27,55,-Inf
2004/2005,28,47,2005/2006,23,73,13,60,-Inf
2004/2005,28,48,2005/2006,24,43,18,25,-Inf
2004/2005,28,49,2005/2006,25,55,16,39,-Inf
2004/2005,28,50,2005/2006,26,55,16,39,-Inf
2004/2005,28,51,2005/2006,27,53,20,33,-Inf
2004/2005,28,52,2005/2006,28,46,17,29,-Inf
2004/2005,29,24,2005/2006,1,4,10,6,-Inf
2004/2005,29,25,2005/2006,2,2,7,5,-11.512925464970229
2004/2005,29,26,2005/2006,3,6,5,1,-11.512925464970229
2004/2005,29,27,2005/2006,4,3,3,0,-0.369297126725721
2004/2005,29,28,2005/2006,5,4,12,8,-Inf
2004/2005,29,29,2005/2006,6,10,13,3,-Inf
2004/2005,29,30,2005/2006,7,12,10,2,-Inf
2004/2005,29,31,2005/2006,8,21,13,8,-Inf
2004/2005,29,32,2005/2006,9,26,13,13,-Inf
2004/2005,29,33,2005/2006,10,21,8,13,-Inf
2004/2005,29,34,2005/2006,11,30,21,9,-Inf
2004/2005,29,35,2005/2006,12,45,18,27,-Inf
2004/2005,29,36,2005/2006,13,56,8,48,-Inf
2004/2005,29,37,2005/2006,14,75,7,68,-Inf
2004/2005,29,38,2005/2006,15,83,20,63,-Inf
2004/2005,29,39,2005/2006,16,82,14,68,-Inf
2004/2005,29,40,2005/2006,17,126,14,112,-Inf
2004/2005,29,41,2005/2006,18,119,7,112,-Inf
2004/2005,29,42,2005/2006,19,137,14,123,-Inf
2004/2005,29,43,2005/2006,20,131,10,121,-Inf
2004/2005,29,44,2005/2006,21,112,13,99,-Inf
2004/2005,29,45,2005/2006,22,82,27,55,-11.512925464970229
2004/2005,29,46,2005/2006,23,73,13,60,-Inf
2004/2005,29,47,2005/2006,24,43,18,25,-Inf
2004/2005,29,48,2005/2006,25,55,16,39,-Inf
2004/2005,29,49,2005/2006,26,55,16,39,-Inf
2004/2005,29,50,2005/2006,27,53,20,33,-Inf
2004/2005,29,51,2005/2006,28,46,17,29,-Inf
2004/2005,29,52,2005/2006,29,43,4,39,-Inf
2004/2005,2,51,2005/2006,1,4,10,6,-Inf
2004/2005,2,52,2005/2006,2,2,7,5,-Inf
2004/2005,30,23,2005/2006,1,4,10,6,-Inf
2004/2005,30,24,2005/2006,2,2,7,5,-Inf
2004/2005,30,25,2005/2006,3,6,5,1,-Inf
2004/2005,30,26,2005/2006,4,3,3,0,-0.3729204766324372
2004/2005,30,27,2005/2006,5,4,12,8,-Inf
2004/2005,30,28,2005/2006,6,10,13,3,-11.512925464970229
2004/2005,30,29,2005/2006,7,12,10,2,-10.819778284410283
2004/2005,30,30,2005/2006,8,21,13,8,-Inf
2004/2005,30,31,2005/2006,9,26,13,13,-11.512925464970229
2004/2005,30,32,2005/2006,10,21,8,13,-Inf
2004/2005,30,33,2005/2006,11,30,21,9,-Inf
2004/2005,30,34,2005/2006,12,45,18,27,-Inf
2004/2005,30,35,2005/2006,13,56,8,48,-Inf
2004/2005,30,36,2005/2006,14,75,7,68,-Inf
2004/2005,30,37,2005/2006,15,83,20,63,-Inf
2004/2005,30,38,2005/2006,16,82,14,68,-Inf
2004/2005,30,39,2005/2006,17,126,14,112,-Inf
2004/2005,30,40,2005/2006,18,119,7,112,-Inf
2004/2005,30,41,2005/2006,19,137,14,123,-Inf
2004/2005,30,42,2005/2006,20,131,10,121,-Inf
2004/2005,30,43,2005/2006,21,112,13,99,-Inf
2004/2005,30,44,2005/2006,22,82,27,55,-Inf
2004/2005,30,45,2005/2006,23,73,13,60,-Inf
2004/2005,30,46,2005/2006,24,43,18,25,-Inf
2004/2005,30,47,2005/2006,25,55,16,39,-Inf
2004/2005,30,48,2005/2006,26,55,16,39,-Inf
2004/2005,30,49,2005/2006,27,53,20,33,-Inf
2004/2005,30,50,2005/2006,28,46,17,29,-Inf
2004/2005,30,51,2005/2006,29,43,4,39,-Inf
2004/2005,30,52,2005/2006,30,29,15,14,-Inf
2004/2005,31,22,2005/2006,1,4,10,6,-Inf
2004/2005,31,23,2005/2006,2,2,7,5,-Inf
2004/2005,31,24,2005/2006,3,6,5,1,-Inf
2004/2005,31,25,2005/2006,4,3,3,0,-0.3733416362799513
2004/2005,31,26,2005/2006,5,4,12,8,-Inf
2004/2005,31,27,2005/2006,6,10,13,3,-Inf
2004/2005,31,28,2005/2006,7,12,10,2,-Inf
2004/2005,31,29,2005/2006,8,21,13,8,-Inf
2004/2005,31,30,2005/2006,9,26,13,13,-Inf
2004/2005,31,31,2005/2006,10,21,8,13,-11.512925464970229
2004/2005,31,32,2005/2006,11,30,21,9,-11.512925464970229
2004/2005,31,33,2005/2006,12,45,18,27,-Inf
2004/2005,31,34,2005/2006,13,56,8,48,-Inf
2004/2005,31,35,2005/2006,14,75,7,68,-Inf
2004/2005,31,36,2005/2006,15,83,20,63,-Inf
2004/2005,31,37,2005/2006,16,82,14,68,-Inf
2004/2005,31,38,2005/2006,17,126,14,112,-Inf
2004/2005,31,39,2005/2006,18,119,7,112,-Inf
2004/2005,31,40,2005/2006,19,137,14,123,-Inf
2004/2005,31,41,2005/2006,20,131,10,121,-Inf
2004/2005,31,42,2005/2006,21,112,13,99,-Inf
2004/2005,31,43,2005/2006,22,82,27,55,-Inf
2004/2005,31,44,2005/2006,23,73,13,60,-Inf
2004/2005,31,45,2005/2006,24,43,18,25,-Inf
2004/2005,31,46,2005/2006,25,55,16,39,-Inf
2004/2005,31,47,2005/2006,26,55,16,39,-Inf
2004/2005,31,48,2005/2006,27,53,20,33,-Inf
2004/2005,31,49,2005/2006,28,46,17,29,-Inf
2004/2005,31,50,2005/2006,29,43,4,39,-Inf
2004/2005,31,51,2005/2006,30,29,15,14,-Inf
2004/2005,31,52,2005/2006,31,22,8,14,-Inf
2004/2005,32,21,2005/2006,1,4,10,6,-11.512925464970229
2004/2005,32,22,2005/2006,2,2,7,5,-Inf
2004/2005,32,23,2005/2006,3,6,5,1,-Inf
2004/2005,32,24,2005/2006,4,3,3,0,-0.37861385145748727
2004/2005,32,25,2005/2006,5,4,12,8,-Inf
2004/2005,32,26,2005/2006,6,10,13,3,-11.512925464970229
2004/2005,32,27,2005/2006,7,12,10,2,-11.512925464970229
2004/2005,32,28,2005/2006,8,21,13,8,-Inf
2004/2005,32,29,2005/2006,9,26,13,13,-Inf
2004/2005,32,30,2005/2006,10,21,8,13,-Inf
2004/2005,32,31,2005/2006,11,30,21,9,-11.512925464970229
2004/2005,32,32,2005/2006,12,45,18,27,-Inf
2004/2005,32,33,2005/2006,13,56,8,48,-Inf
2004/2005,32,34,2005/2006,14,75,7,68,-Inf
2004/2005,32,35,2005/2006,15,83,20,63,-Inf
2004/2005,32,36,2005/2006,16,82,14,68,-Inf
2004/2005,32,37,2005/2006,17,126,14,112,-Inf
2004/2005,32,38,2005/2006,18,119,7,112,-Inf
2004/2005,32,39,2005/2006,19,137,14,123,-Inf
2004/2005,32,40,2005/2006,20,131,10,121,-Inf
2004/2005,32,41,2005/2006,21,112,13,99,-Inf
2004/2005,32,42,2005/2006,22,82,27,55,-Inf
2004/2005,32,43,2005/2006,23,73,13,60,-Inf
2004/2005,32,44,2005/2006,24,43,18,25,-Inf
2004/2005,32,45,2005/2006,25,55,16,39,-11.512925464970229
2004/2005,32,46,2005/2006,26,55,16,39,-Inf
2004/2005,32,47,2005/2006,27,53,20,33,-Inf
2004/2005,32,48,2005/2006,28,46,17,29,-Inf
2004/2005,32,49,2005/2006,29,43,4,39,-Inf
2004/2005,32,50,2005/2006,30,29,15,14,-Inf
2004/2005,32,51,2005/2006,31,22,8,14,-Inf
2004/2005,32,52,2005/2006,32,26,6,20,-11.512925464970229
2004/2005,33,20,2005/2006,1,4,10,6,-11.512925464970229
2004/2005,33,21,2005/2006,2,2,7,5,-Inf
2004/2005,33,22,2005/2006,3,6,5,1,-Inf
2004/2005,33,23,2005/2006,4,3,3,0,-0.378205062489096
2004/2005,33,24,2005/2006,5,4,12,8,-11.512925464970229
2004/2005,33,25,2005/2006,6,10,13,3,-Inf
2004/2005,33,26,2005/2006,7,12,10,2,-11.512925464970229
2004/2005,33,27,2005/2006,8,21,13,8,-Inf
2004/2005,33,28,2005/2006,9,26,13,13,-Inf
2004/2005,33,29,2005/2006,10,21,8,13,-Inf
2004/2005,33,30,2005/2006,11,30,21,9,-Inf
2004/2005,33,31,2005/2006,12,45,18,27,-Inf
2004/2005,33,32,2005/2006,13,56,8,48,-Inf
2004/2005,33,33,2005/2006,14,75,7,68,-Inf
2004/2005,33,34,2005/2006,15,83,20,63,-Inf
2004/2005,33,35,2005/2006,16,82,14,68,-Inf
2004/2005,33,36,2005/2006,17,126,14,112,-Inf
2004/2005,33,37,2005/2006,18,119,7,112,-Inf
2004/2005,33,38,2005/2006,19,137,14,123,-Inf
2004/2005,33,39,2005/2006,20,131,10,121,-Inf
2004/2005,33,40,2005/2006,21,112,13,99,-Inf
2004/2005,33,41,2005/2006,22,82,27,55,-Inf
2004/2005,33,42,2005/2006,23,73,13,60,-Inf
2004/2005,33,43,2005/2006,24,43,18,25,-Inf
2004/2005,33,44,2005/2006,25,55,16,39,-Inf
2004/2005,33,45,2005/2006,26,55,16,39,-Inf
2004/2005,33,46,2005/2006,27,53,20,33,-Inf
2004/2005,33,47,2005/2006,28,46,17,29,-Inf
2004/2005,33,48,2005/2006,29,43,4,39,-Inf
2004/2005,33,49,2005/2006,30,29,15,14,-Inf
2004/2005,33,50,2005/2006,31,22,8,14,-Inf
2004/2005,33,51,2005/2006,32,26,6,20,-Inf
2004/2005,33,52,2005/2006,33,13,12,1,-Inf
2004/2005,34,19,2005/2006,1,4,10,6,-Inf
2004/2005,34,20,2005/2006,2,2,7,5,-Inf
2004/2005,34,21,2005/2006,3,6,5,1,-Inf
2004/2005,34,22,2005/2006,4,3,3,0,-0.3253285586840562
2004/2005,34,23,2005/2006,5,4,12,8,-Inf
2004/2005,34,24,2005/2006,6,10,13,3,-11.512925464970229
2004/2005,34,25,2005/2006,7,12,10,2,-11.512925464970229
2004/2005,34,26,2005/2006,8,21,13,8,-Inf
2004/2005,34,27,2005/2006,9,26,13,13,-Inf
2004/2005,34,28,2005/2006,10,21,8,13,-Inf
2004/2005,34,29,2005/2006,11,30,21,9,-Inf
2004/2005,34,30,2005/2006,12,45,18,27,-Inf
2004/2005,34,31,2005/2006,13,56,8,48,-Inf
2004/2005,34,32,2005/2006,14,75,7,68,-Inf
2004/2005,34,33,2005/2006,15,83,20,63,-Inf
2004/2005,34,34,2005/2006,16,82,14,68,-Inf
2004/2005,34,35,2005/2006,17,126,14,112,-Inf
2004/2005,34,36,2005/2006,18,119,7,112,-Inf
2004/2005,34,37,2005/2006,19,137,14,123,-Inf
2004/2005,34,38,2005/2006,20,131,10,121,-Inf
2004/2005,34,39,2005/2006,21,112,13,99,-Inf
2004/2005,34,40,2005/2006,22,82,27,55,-Inf
2004/2005,34,41,2005/2006,23,73,13,60,-Inf
2004/2005,34,42,2005/2006,24,43,18,25,-Inf
2004/2005,34,43,2005/2006,25,55,16,39,-Inf
2004/2005,34,44,2005/2006,26,55,16,39,-Inf
2004/2005,34,45,2005/2006,27,53,20,33,-Inf
2004/2005,34,46,2005/2006,28,46,17,29,-Inf
2004/2005,34,47,2005/2006,29,43,4,39,-Inf
2004/2005,34,48,2005/2006,30,29,15,14,-Inf
2004/2005,34,49,2005/2006,31,22,8,14,-Inf
2004/2005,34,50,2005/2006,32,26,6,20,-Inf
2004/2005,34,51,2005/2006,33,13,12,1,-11.512925464970229
2004/2005,34,52,2005/2006,34,17,15,2,-Inf
2004/2005,35,18,2005/2006,1,4,10,6,-Inf
2004/2005,35,19,2005/2006,2,2,7,5,-11.512925464970229
2004/2005,35,20,2005/2006,3,6,5,1,-10.819778284410283
2004/2005,35,21,2005/2006,4,3,3,0,-0.34187078258301185
2004/2005,35,22,2005/2006,5,4,12,8,-11.512925464970229
2004/2005,35,23,2005/2006,6,10,13,3,-11.512925464970229
2004/2005,35,24,2005/2006,7,12,10,2,-Inf
2004/2005,35,25,2005/2006,8,21,13,8,-Inf
2004/2005,35,26,2005/2006,9,26,13,13,-Inf
2004/2005,35,27,2005/2006,10,21,8,13,-Inf
2004/2005,35,28,2005/2006,11,30,21,9,-Inf
2004/2005,35,29,2005/2006,12,45,18,27,-Inf
2004/2005,35,30,2005/2006,13,56,8,48,-Inf
2004/2005,35,31,2005/2006,14,75,7,68,-Inf
2004/2005,35,32,2005/2006,15,83,20,63,-Inf
2004/2005,35,33,2005/2006,16,82,14,68,-Inf
2004/2005,35,34,2005/2006,17,126,14,112,-Inf
2004/2005,35,35,2005/2006,18,119,7,112,-Inf
2004/2005,35,36,2005/2006,19,137,14,123,-Inf
2004/2005,35,37,2005/2006,20,131,10,121,-Inf
2004/2005,35,38,2005/2006,21,112,13,99,-Inf
2004/2005,35,39,2005/2006,22,82,27,55,-Inf
2004/2005,35,40,2005/2006,23,73,13,60,-Inf
2004/2005,35,41,2005/2006,24,43,18,25,-Inf
2004/2005,35,42,2005/2006,25,55,16,39,-Inf
2004/2005,35,43,2005/2006,26,55,16,39,-Inf
2004/2005,35,44,2005/2006,27,53,20,33,-Inf
2004/2005,35,45,2005/2006,28,46,17,29,-Inf
2004/2005,35,46,2005/2006,29,43,4,39,-Inf
2004/2005,35,47,2005/2006,30,29,15,14,-Inf
2004/2005,35,48,2005/2006,31,22,8,14,-Inf
2004/2005,35,49,2005/2006,32,26,6,20,-Inf
2004/2005,35,50,2005/2006,33,13,12,1,-Inf
2004/2005,35,51,2005/2006,34,17,15,2,-Inf
2004/2005,35,52,2005/2006,35,8,11,3,-Inf
2004/2005,36,17,2005/2006,1,4,10,6,-Inf
2004/2005,36,18,2005/2006,2,2,7,5,-11.512925464970229
2004/2005,36,19,2005/2006,3,6,5,1,-11.512925464970229
2004/2005,36,20,2005/2006,4,3,3,0,-0.34862174389113676
2004/2005,36,21,2005/2006,5,4,12,8,-11.512925464970229
2004/2005,36,22,2005/2006,6,10,13,3,-11.512925464970229
2004/2005,36,23,2005/2006,7,12,10,2,-11.512925464970229
2004/2005,36,24,2005/2006,8,21,13,8,-Inf
2004/2005,36,25,2005/2006,9,26,13,13,-Inf
2004/2005,36,26,2005/2006,10,21,8,13,-Inf
2004/2005,36,27,2005/2006,11,30,21,9,-Inf
2004/2005,36,28,2005/2006,12,45,18,27,-Inf
2004/2005,36,29,2005/2006,13,56,8,48,-Inf
2004/2005,36,30,2005/2006,14,75,7,68,-Inf
2004/2005,36,31,2005/2006,15,83,20,63,-Inf
2004/2005,36,32,2005/2006,16,82,14,68,-Inf
2004/2005,36,33,2005/2006,17,126,14,112,-Inf
2004/2005,36,34,2005/2006,18,119,7,112,-Inf
2004/2005,36,35,2005/2006,19,137,14,123,-Inf
2004/2005,36,36,2005/2006,20,131,10,121,-Inf
2004/2005,36,37,2005/2006,21,112,13,99,-Inf
2004/2005,36,38,2005/2006,22,82,27,55,-Inf
2004/2005,36,39,2005/2006,23,73,13,60,-Inf
2004/2005,36,40,2005/2006,24,43,18,25,-Inf
2004/2005,36,41,2005/2006,25,55,16,39,-11.512925464970229
2004/2005,36,42,2005/2006,26,55,16,39,-Inf
2004/2005,36,43,2005/2006,27,53,20,33,-Inf
2004/2005,36,44,2005/2006,28,46,17,29,-Inf
2004/2005,36,45,2005/2006,29,43,4,39,-Inf
2004/2005,36,46,2005/2006,30,29,15,14,-Inf
2004/2005,36,47,2005/2006,31,22,8,14,-Inf
2004/2005,36,48,2005/2006,32,26,6,20,-Inf
2004/2005,36,49,2005/2006,33,13,12,1,-Inf
2004/2005,36,50,2005/2006,34,17,15,2,-Inf
2004/2005,36,51,2005/2006,35,8,11,3,-Inf
2004/2005,36,52,2005/2006,36,13,10,3,-Inf
2004/2005,37,16,2005/2006,1,4,10,6,-11.512925464970229
2004/2005,37,17,2005/2006,2,2,7,5,-Inf
2004/2005,37,18,2005/2006,3,6,5,1,-Inf
2004/2005,37,19,2005/2006,4,3,3,0,-0.35929265286538836
2004/2005,37,20,2005/2006,5,4,12,8,-Inf
2004/2005,37,21,2005/2006,6,10,13,3,-11.512925464970229
2004/2005,37,22,2005/2006,7,12,10,2,-Inf
2004/2005,37,23,2005/2006,8,21,13,8,-Inf
2004/2005,37,24,2005/2006,9,26,13,13,-Inf
2004/2005,37,25,2005/2006,10,21,8,13,-Inf
2004/2005,37,26,2005/2006,11,30,21,9,-Inf
2004/2005,37,27,2005/2006,12,45,18,27,-Inf
2004/2005,37,28,2005/2006,13,56,8,48,-Inf
2004/2005,37,29,2005/2006,14,75,7,68,-Inf
2004/2005,37,30,2005/2006,15,83,20,63,-Inf
2004/2005,37,31,2005/2006,16,82,14,68,-Inf
2004/2005,37,32,2005/2006,17,126,14,112,-Inf
2004/2005,37,33,2005/2006,18,119,7,112,-Inf
2004/2005,37,34,2005/2006,19,137,14,123,-Inf
2004/2005,37,35,2005/2006,20,131,10,121,-Inf
2004/2005,37,36,2005/2006,21,112,13,99,-Inf
2004/2005,37,37,2005/2006,22,82,27,55,-Inf
2004/2005,37,38,2005/2006,23,73,13,60,-Inf
2004/2005,37,39,2005/2006,24,43,18,25,-Inf
2004/2005,37,40,2005/2006,25,55,16,39,-Inf
2004/2005,37,41,2005/2006,26,55,16,39,-Inf
2004/2005,37,42,2005/2006,27,53,20,33,-11.512925464970229
2004/2005,37,43,2005/2006,28,46,17,29,-Inf
2004/2005,37,44,2005/2006,29,43,4,39,-Inf
2004/2005,37,45,2005/2006,30,29,15,14,-Inf
2004/2005,37,46,2005/2006,31,22,8,14,-Inf
2004/2005,37,47,2005/2006,32,26,6,20,-Inf
2004/2005,37,48,2005/2006,33,13,12,1,-10.41431317630212
2004/2005,37,49,2005/2006,34,17,15,2,-Inf
2004/2005,37,50,2005/2006,35,8,11,3,-11.512925464970229
2004/2005,37,51,2005/2006,36,13,10,3,-11.512925464970229
2004/2005,37,52,2005/2006,37,10,15,5,-11.512925464970229
2004/2005,38,15,2005/2006,1,4,10,6,-11.512925464970229
2004/2005,38,16,2005/2006,2,2,7,5,-Inf
2004/2005,38,17,2005/2006,3,6,5,1,-10.819778284410283
2004/2005,38,18,2005/2006,4,3,3,0,-0.27154629054237667
2004/2005,38,19,2005/2006,5,4,12,8,-Inf
2004/2005,38,20,2005/2006,6,10,13,3,-Inf
2004/2005,38,21,2005/2006,7,12,10,2,-Inf
2004/2005,38,22,2005/2006,8,21,13,8,-Inf
2004/2005,38,23,2005/2006,9,26,13,13,-Inf
2004/2005,38,24,2005/2006,10,21,8,13,-Inf
2004/2005,38,25,2005/2006,11,30,21,9,-Inf
2004/2005,38,26,2005/2006,12,45,18,27,-Inf
2004/2005,38,27,2005/2006,13,56,8,48,-Inf
2004/2005,38,28,2005/2006,14,75,7,68,-Inf
2004/2005,38,29,2005/2006,15,83,20,63,-Inf
2004/2005,38,30,2005/2006,16,82,14,68,-Inf
2004/2005,38,31,2005/2006,17,126,14,112,-Inf
2004/2005,38,32,2005/2006,18,119,7,112,-Inf
2004/2005,38,33,2005/2006,19,137,14,123,-Inf
2004/2005,38,34,2005/2006,20,131,10,121,-Inf
2004/2005,38,35,2005/2006,21,112,13,99,-Inf
2004/2005,38,36,2005/2006,22,82,27,55,-Inf
2004/2005,38,37,2005/2006,23,73,13,60,-Inf
2004/2005,38,38,2005/2006,24,43,18,25,-Inf
2004/2005,38,39,2005/2006,25,55,16,39,-Inf
2004/2005,38,40,2005/2006,26,55,16,39,-Inf
2004/2005,38,41,2005/2006,27,53,20,33,-Inf
2004/2005,38,42,2005/2006,28,46,17,29,-Inf
2004/2005,38,43,2005/2006,29,43,4,39,-Inf
2004/2005,38,44,2005/2006,30,29,15,14,-Inf
2004/2005,38,45,2005/2006,31,22,8,14,-Inf
2004/2005,38,46,2005/2006,32,26,6,20,-Inf
2004/2005,38,47,2005/2006,33,13,12,1,-11.512925464970229
2004/2005,38,48,2005/2006,34,17,15,2,-Inf
2004/2005,38,49,2005/2006,35,8,11,3,-Inf
2004/2005,38,50,2005/2006,36,13,10,3,-Inf
2004/2005,38,51,2005/2006,37,10,15,5,-Inf
2004/2005,38,52,2005/2006,38,17,17,0,-0.34243397250553365
2004/2005,39,14,2005/2006,1,4,10,6,-Inf
2004/2005,39,15,2005/2006,2,2,7,5,-Inf
2004/2005,39,16,2005/2006,3,6,5,1,-11.512925464970229
2004/2005,39,17,2005/2006,4,3,3,0,-0.29917452509709896
2004/2005,39,18,2005/2006,5,4,12,8,-Inf
2004/2005,39,19,2005/2006,6,10,13,3,-11.512925464970229
2004/2005,39,20,2005/2006,7,12,10,2,-11.512925464970229
2004/2005,39,21,2005/2006,8,21,13,8,-Inf
2004/2005,39,22,2005/2006,9,26,13,13,-Inf
2004/2005,39,23,2005/2006,10,21,8,13,-Inf
2004/2005,39,24,2005/2006,11,30,21,9,-Inf
2004/2005,39,25,2005/2006,12,45,18,27,-Inf
2004/2005,39,26,2005/2006,13,56,8,48,-Inf
2004/2005,39,27,2005/2006,14,75,7,68,-Inf
2004/2005,39,28,2005/2006,15,83,20,63,-Inf
2004/2005,39,29,2005/2006,16,82,14,68,-Inf
2004/2005,39,30,2005/2006,17,126,14,112,-Inf
2004/2005,39,31,2005/2006,18,119,7,112,-Inf
2004/2005,39,32,2005/2006,19,137,14,123,-Inf
2004/2005,39,33,2005/2006,20,131,10,121,-Inf
2004/2005,39,34,2005/2006,21,112,13,99,-Inf
2004/2005,39,35,2005/2006,22,82,27,55,-Inf
2004/2005,39,36,2005/2006,23,73,13,60,-Inf
2004/2005,39,37,2005/2006,24,43,18,25,-Inf
2004/2005,39,38,2005/2006,25,55,16,39,-Inf
2004/2005,39,39,2005/2006,26,55,16,39,-Inf
2004/2005,39,40,2005/2006,27,53,20,33,-Inf
2004/2005,39,41,2005/2006,28,46,17,29,-Inf
2004/2005,39,42,2005/2006,29,43,4,39,-Inf
2004/2005,39,43,2005/2006,30,29,15,14,-11.512925464970229
2004/2005,39,44,2005/2006,31,22,8,14,-Inf
2004/2005,39,45,2005/2006,32,26,6,20,-Inf
2004/2005,39,46,2005/2006,33,13,12,1,-Inf
2004/2005,39,47,2005/2006,34,17,15,2,-Inf
2004/2005,39,48,2005/2006,35,8,11,3,-Inf
2004/2005,39,49,2005/2006,36,13,10,3,-Inf
2004/2005,39,50,2005/2006,37,10,15,5,-10.819778284410283
2004/2005,39,51,2005/2006,38,17,17,0,-0.34615900221075613
2004/2005,39,52,2005/2006,39,19,7,12,-Inf
2004/2005,3,50,2005/2006,1,4,10,6,-Inf
2004/2005,3,51,2005/2006,2,2,7,5,-Inf
2004/2005,3,52,2005/2006,3,6,5,1,-11.512925464970229
2004/2005,40,13,2005/2006,1,4,10,6,-11.512925464970229
2004/2005,40,14,2005/2006,2,2,7,5,-Inf
2004/2005,40,15,2005/2006,3,6,5,1,-11.512925464970229
2004/2005,40,16,2005/2006,4,3,3,0,-0.31564268581113275
2004/2005,40,17,2005/2006,5,4,12,8,-11.512925464970229
2004/2005,40,18,2005/2006,6,10,13,3,-11.512925464970229
2004/2005,40,19,2005/2006,7,12,10,2,-Inf
2004/2005,40,20,2005/2006,8,21,13,8,-Inf
2004/2005,40,21,2005/2006,9,26,13,13,-Inf
2004/2005,40,22,2005/2006,10,21,8,13,-Inf
2004/2005,40,23,2005/2006,11,30,21,9,-Inf
2004/2005,40,24,2005/2006,12,45,18,27,-Inf
2004/2005,40,25,2005/2006,13,56,8,48,-Inf
2004/2005,40,26,2005/2006,14,75,7,68,-Inf
2004/2005,40,27,2005/2006,15,83,20,63,-Inf
2004/2005,40,28,2005/2006,16,82,14,68,-Inf
2004/2005,40,29,2005/2006,17,126,14,112,-Inf
2004/2005,40,30,2005/2006,18,119,7,112,-Inf
2004/2005,40,31,2005/2006,19,137,14,123,-Inf
2004/2005,40,32,2005/2006,20,131,10,121,-Inf
2004/2005,40,33,2005/2006,21,112,13,99,-Inf
2004/2005,40,34,2005/2006,22,82,27,55,-Inf
2004/2005,40,35,2005/2006,23,73,13,60,-Inf
2004/2005,40,36,2005/2006,24,43,18,25,-Inf
2004/2005,40,37,2005/2006,25,55,16,39,-Inf
2004/2005,40,38,2005/2006,26,55,16,39,-Inf
2004/2005,40,39,2005/2006,27,53,20,33,-Inf
2004/2005,40,40,2005/2006,28,46,17,29,-Inf
2004/2005,40,41,2005/2006,29,43,4,39,-Inf
2004/2005,40,42,2005/2006,30,29,15,14,-Inf
2004/2005,40,43,2005/2006,31,22,8,14,-Inf
2004/2005,40,44,2005/2006,32,26,6,20,-Inf
2004/2005,40,45,2005/2006,33,13,12,1,-10.819778284410283
2004/2005,40,46,2005/2006,34,17,15,2,-Inf
2004/2005,40,47,2005/2006,35,8,11,3,-Inf
2004/2005,40,48,2005/2006,36,13,10,3,-11.512925464970229
2004/2005,40,49,2005/2006,37,10,15,5,-Inf
2004/2005,40,50,2005/2006,38,17,17,0,-0.3498412043601675
2004/2005,40,51,2005/2006,39,19,7,12,-Inf
2004/2005,40,52,2005/2006,40,9,7,2,-11.512925464970229
2004/2005,41,12,2005/2006,1,4,10,6,-Inf
2004/2005,41,13,2005/2006,2,2,7,5,-Inf
2004/2005,41,14,2005/2006,3,6,5,1,-Inf
2004/2005,41,15,2005/2006,4,3,3,0,-0.34129384190043055
2004/2005,41,16,2005/2006,5,4,12,8,-Inf
2004/2005,41,17,2005/2006,6,10,13,3,-Inf
2004/2005,41,18,2005/2006,7,12,10,2,-Inf
2004/2005,41,19,2005/2006,8,21,13,8,-Inf
2004/2005,41,20,2005/2006,9,26,13,13,-Inf
2004/2005,41,21,2005/2006,10,21,8,13,-11.512925464970229
2004/2005,41,22,2005/2006,11,30,21,9,-Inf
2004/2005,41,23,2005/2006,12,45,18,27,-Inf
2004/2005,41,24,2005/2006,13,56,8,48,-Inf
2004/2005,41,25,2005/2006,14,75,7,68,-Inf
2004/2005,41,26,2005/2006,15,83,20,63,-Inf
2004/2005,41,27,2005/2006,16,82,14,68,-Inf
2004/2005,41,28,2005/2006,17,126,14,112,-Inf
2004/2005,41,29,2005/2006,18,119,7,112,-Inf
2004/2005,41,30,2005/2006,19,137,14,123,-Inf
2004/2005,41,31,2005/2006,20,131,10,121,-Inf
2004/2005,41,32,2005/2006,21,112,13,99,-Inf
2004/2005,41,33,2005/2006,22,82,27,55,-Inf
2004/2005,41,34,2005/2006,23,73,13,60,-Inf
2004/2005,41,35,2005/2006,24,43,18,25,-Inf
2004/2005,41,36,2005/2006,25,55,16,39,-Inf
2004/2005,41,37,2005/2006,26,55,16,39,-Inf
2004/2005,41,38,2005/2006,27,53,20,33,-Inf
2004/2005,41,39,2005/2006,28,46,17,29,-Inf
2004/2005,41,40,2005/2006,29,43,4,39,-Inf
2004/2005,41,41,2005/2006,30,29,15,14,-Inf
2004/2005,41,42,2005/2006,31,22,8,14,-Inf
2004/2005,41,43,2005/2006,32,26,6,20,-Inf
2004/2005,41,44,2005/2006,33,13,12,1,-10.819778284410283
2004/2005,41,45,2005/2006,34,17,15,2,-Inf
2004/2005,41,46,2005/2006,35,8,11,3,-Inf
2004/2005,41,47,2005/2006,36,13,10,3,-Inf
2004/2005,41,48,2005/2006,37,10,15,5,-Inf
2004/2005,41,49,2005/2006,38,17,17,0,-0.34785679548785176
2004/2005,41,50,2005/2006,39,19,7,12,-Inf
2004/2005,41,51,2005/2006,40,9,7,2,-Inf
2004/2005,41,52,2005/2006,41,9,8,1,-Inf
2004/2005,42,11,2005/2006,1,4,10,6,-11.512925464970229
2004/2005,42,12,2005/2006,2,2,7,5,-Inf
2004/2005,42,13,2005/2006,3,6,5,1,-Inf
2004/2005,42,14,2005/2006,4,3,3,0,-0.36355570503095436
2004/2005,42,15,2005/2006,5,4,12,8,-11.512925464970229
2004/2005,42,16,2005/2006,6,10,13,3,-11.512925464970229
2004/2005,42,17,2005/2006,7,12,10,2,-Inf
2004/2005,42,18,2005/2006,8,21,13,8,-Inf
2004/2005,42,19,2005/2006,9,26,13,13,-Inf
2004/2005,42,20,2005/2006,10,21,8,13,-Inf
2004/2005,42,21,2005/2006,11,30,21,9,-Inf
2004/2005,42,22,2005/2006,12,45,18,27,-Inf
2004/2005,42,23,2005/2006,13,56,8,48,-Inf
2004/2005,42,24,2005/2006,14,75,7,68,-Inf
2004/2005,42,25,2005/2006,15,83,20,63,-Inf
2004/2005,42,26,2005/2006,16,82,14,68,-11.512925464970229
2004/2005,42,27,2005/2006,17,126,14,112,-Inf
2004/2005,42,28,2005/2006,18,119,7,112,-Inf
2004/2005,42,29,2005/2006,19,137,14,123,-Inf
2004/2005,42,30,2005/2006,20,131,10,121,-Inf
2004/2005,42,31,2005/2006,21,112,13,99,-Inf
2004/2005,42,32,2005/2006,22,82,27,55,-Inf
2004/2005,42,33,2005/2006,23,73,13,60,-Inf
2004/2005,42,34,2005/2006,24,43,18,25,-Inf
2004/2005,42,35,2005/2006,25,55,16,39,-Inf
2004/2005,42,36,2005/2006,26,55,16,39,-Inf
2004/2005,42,37,2005/2006,27,53,20,33,-Inf
2004/2005,42,38,2005/2006,28,46,17,29,-Inf
2004/2005,42,39,2005/2006,29,43,4,39,-Inf
2004/2005,42,40,2005/2006,30,29,15,14,-Inf
2004/2005,42,41,2005/2006,31,22,8,14,-Inf
2004/2005,42,42,2005/2006,32,26,6,20,-Inf
2004/2005,42,43,2005/2006,33,13,12,1,-10.819778284410283
2004/2005,42,44,2005/2006,34,17,15,2,-Inf
2004/2005,42,45,2005/2006,35,8,11,3,-11.512925464970229
2004/2005,42,46,2005/2006,36,13,10,3,-Inf
2004/2005,42,47,2005/2006,37,10,15,5,-Inf
2004/2005,42,48,2005/2006,38,17,17,0,-0.35352277439221425
2004/2005,42,49,2005/2006,39,19,7,12,-Inf
2004/2005,42,50,2005/2006,40,9,7,2,-Inf
2004/2005,42,51,2005/2006,41,9,8,1,-10.819778284410283
2004/2005,42,52,2005/2006,42,9,9,0,-0.3504798872758208
2004/2005,43,10,2005/2006,1,4,10,6,-Inf
2004/2005,43,11,2005/2006,2,2,7,5,-Inf
2004/2005,43,12,2005/2006,3,6,5,1,-11.512925464970229
2004/2005,43,13,2005/2006,4,3,3,0,-0.24542750455494478
2004/2005,43,14,2005/2006,5,4,12,8,-Inf
2004/2005,43,15,2005/2006,6,10,13,3,-Inf
2004/2005,43,16,2005/2006,7,12,10,2,-10.819778284410283
2004/2005,43,17,2005/2006,8,21,13,8,-Inf
2004/2005,43,18,2005/2006,9,26,13,13,-Inf
2004/2005,43,19,2005/2006,10,21,8,13,-Inf
2004/2005,43,20,2005/2006,11,30,21,9,-Inf
2004/2005,43,21,2005/2006,12,45,18,27,-Inf
2004/2005,43,22,2005/2006,13,56,8,48,-Inf
2004/2005,43,23,2005/2006,14,75,7,68,-Inf
2004/2005,43,24,2005/2006,15,83,20,63,-Inf
2004/2005,43,25,2005/2006,16,82,14,68,-Inf
2004/2005,43,26,2005/2006,17,126,14,112,-Inf
2004/2005,43,27,2005/2006,18,119,7,112,-Inf
2004/2005,43,28,2005/2006,19,137,14,123,-Inf
2004/2005,43,29,2005/2006,20,131,10,121,-Inf
2004/2005,43,30,2005/2006,21,112,13,99,-Inf
2004/2005,43,31,2005/2006,22,82,27,55,-Inf
2004/2005,43,32,2005/2006,23,73,13,60,-Inf
2004/2005,43,33,2005/2006,24,43,18,25,-Inf
2004/2005,43,34,2005/2006,25,55,16,39,-Inf
2004/2005,43,35,2005/2006,26,55,16,39,-Inf
2004/2005,43,36,2005/2006,27,53,20,33,-Inf
2004/2005,43,37,2005/2006,28,46,17,29,-Inf
2004/2005,43,38,2005/2006,29,43,4,39,-Inf
2004/2005,43,39,2005/2006,30,29,15,14,-Inf
2004/2005,43,40,2005/2006,31,22,8,14,-Inf
2004/2005,43,41,2005/2006,32,26,6,20,-Inf
2004/2005,43,42,2005/2006,33,13,12,1,-10.41431317630212
2004/2005,43,43,2005/2006,34,17,15,2,-11.512925464970229
2004/2005,43,44,2005/2006,35,8,11,3,-Inf
2004/2005,43,45,2005/2006,36,13,10,3,-Inf
2004/2005,43,46,2005/2006,37,10,15,5,-Inf
2004/2005,43,47,2005/2006,38,17,17,0,-0.34154709194399224
2004/2005,43,48,2005/2006,39,19,7,12,-Inf
2004/2005,43,49,2005/2006,40,9,7,2,-11.512925464970229
2004/2005,43,50,2005/2006,41,9,8,1,-11.512925464970229
2004/2005,43,51,2005/2006,42,9,9,0,-0.34249030894677546
2004/2005,43,52,2005/2006,43,3,12,9,-Inf
2004/2005,44,9,2005/2006,1,4,10,6,-Inf
2004/2005,44,10,2005/2006,2,2,7,5,-Inf
2004/2005,44,11,2005/2006,3,6,5,1,-10.819778284410283
2004/2005,44,12,2005/2006,4,3,3,0,-0.2369129154002092
2004/2005,44,13,2005/2006,5,4,12,8,-Inf
2004/2005,44,14,2005/2006,6,10,13,3,-11.512925464970229
2004/2005,44,15,2005/2006,7,12,10,2,-10.819778284410283
2004/2005,44,16,2005/2006,8,21,13,8,-Inf
2004/2005,44,17,2005/2006,9,26,13,13,-Inf
2004/2005,44,18,2005/2006,10,21,8,13,-Inf
2004/2005,44,19,2005/2006,11,30,21,9,-Inf
2004/2005,44,20,2005/2006,12,45,18,27,-Inf
2004/2005,44,21,2005/2006,13,56,8,48,-Inf
2004/2005,44,22,2005/2006,14,75,7,68,-Inf
2004/2005,44,23,2005/2006,15,83,20,63,-Inf
2004/2005,44,24,2005/2006,16,82,14,68,-Inf
2004/2005,44,25,2005/2006,17,126,14,112,-Inf
2004/2005,44,26,2005/2006,18,119,7,112,-Inf
2004/2005,44,27,2005/2006,19,137,14,123,-Inf
2004/2005,44,28,2005/2006,20,131,10,121,-Inf
2004/2005,44,29,2005/2006,21,112,13,99,-Inf
2004/2005,44,30,2005/2006,22,82,27,55,-Inf
2004/2005,44,31,2005/2006,23,73,13,60,-Inf
2004/2005,44,32,2005/2006,24,43,18,25,-Inf
2004/2005,44,33,2005/2006,25,55,16,39,-Inf
2004/2005,44,34,2005/2006,26,55,16,39,-Inf
2004/2005,44,35,2005/2006,27,53,20,33,-Inf
2004/2005,44,36,2005/2006,28,46,17,29,-Inf
2004/2005,44,37,2005/2006,29,43,4,39,-Inf
2004/2005,44,38,2005/2006,30,29,15,14,-Inf
2004/2005,44,39,2005/2006,31,22,8,14,-Inf
2004/2005,44,40,2005/2006,32,26,6,20,-Inf
2004/2005,44,41,2005/2006,33,13,12,1,-10.819778284410283
2004/2005,44,42,2005/2006,34,17,15,2,-Inf
2004/2005,44,43,2005/2006,35,8,11,3,-Inf
2004/2005,44,44,2005/2006,36,13,10,3,-Inf
2004/2005,44,45,2005/2006,37,10,15,5,-Inf
2004/2005,44,46,2005/2006,38,17,17,0,-0.3403095898524686
2004/2005,44,47,2005/2006,39,19,7,12,-Inf
2004/2005,44,48,2005/2006,40,9,7,2,-Inf
2004/2005,44,49,2005/2006,41,9,8,1,-Inf
2004/2005,44,50,2005/2006,42,9,9,0,-0.344012593795199
2004/2005,44,51,2005/2006,43,3,12,9,-Inf
2004/2005,44,52,2005/2006,44,7,12,5,-Inf
2004/2005,45,8,2005/2006,1,4,10,6,-Inf
2004/2005,45,9,2005/2006,2,2,7,5,-Inf
2004/2005,45,10,2005/2006,3,6,5,1,-Inf
2004/2005,45,11,2005/2006,4,3,3,0,-0.22548378753210585
2004/2005,45,12,2005/2006,5,4,12,8,-Inf
2004/2005,45,13,2005/2006,6,10,13,3,-10.819778284410283
2004/2005,45,14,2005/2006,7,12,10,2,-Inf
2004/2005,45,15,2005/2006,8,21,13,8,-Inf
2004/2005,45,16,2005/2006,9,26,13,13,-Inf
2004/2005,45,17,2005/2006,10,21,8,13,-Inf
2004/2005,45,18,2005/2006,11,30,21,9,-Inf
2004/2005,45,19,2005/2006,12,45,18,27,-11.512925464970229
2004/2005,45,20,2005/2006,13,56,8,48,-Inf
2004/2005,45,21,2005/2006,14,75,7,68,-Inf
2004/2005,45,22,2005/2006,15,83,20,63,-Inf
2004/2005,45,23,2005/2006,16,82,14,68,-Inf
2004/2005,45,24,2005/2006,17,126,14,112,-Inf
2004/2005,45,25,2005/2006,18,119,7,112,-Inf
2004/2005,45,26,2005/2006,19,137,14,123,-Inf
2004/2005,45,27,2005/2006,20,131,10,121,-Inf
2004/2005,45,28,2005/2006,21,112,13,99,-Inf
2004/2005,45,29,2005/2006,22,82,27,55,-Inf
2004/2005,45,30,2005/2006,23,73,13,60,-Inf
2004/2005,45,31,2005/2006,24,43,18,25,-Inf
2004/2005,45,32,2005/2006,25,55,16,39,-Inf
2004/2005,45,33,2005/2006,26,55,16,39,-Inf
2004/2005,45,34,2005/2006,27,53,20,33,-Inf
2004/2005,45,35,2005/2006,28,46,17,29,-Inf
2004/2005,45,36,2005/2006,29,43,4,39,-Inf
2004/2005,45,37,2005/2006,30,29,15,14,-Inf
2004/2005,45,38,2005/2006,31,22,8,14,-Inf
2004/2005,45,39,2005/2006,32,26,6,20,-Inf
2004/2005,45,40,2005/2006,33,13,12,1,-11.512925464970229
2004/2005,45,41,2005/2006,34,17,15,2,-Inf
2004/2005,45,42,2005/2006,35,8,11,3,-11.512925464970229
2004/2005,45,43,2005/2006,36,13,10,3,-10.819778284410283
2004/2005,45,44,2005/2006,37,10,15,5,-Inf
2004/2005,45,45,2005/2006,38,17,17,0,-0.3403095898524686
2004/2005,45,46,2005/2006,39,19,7,12,-11.512925464970229
2004/2005,45,47,2005/2006,40,9,7,2,-Inf
2004/2005,45,48,2005/2006,41,9,8,1,-10.819778284410283
2004/2005,45,49,2005/2006,42,9,9,0,-0.3399864040810705
2004/2005,45,50,2005/2006,43,3,12,9,-Inf
2004/2005,45,51,2005/2006,44,7,12,5,-Inf
2004/2005,45,52,2005/2006,45,7,5,2,-11.512925464970229
2004/2005,46,7,2005/2006,1,4,10,6,-Inf
2004/2005,46,8,2005/2006,2,2,7,5,-Inf
2004/2005,46,9,2005/2006,3,6,5,1,-Inf
2004/2005,46,10,2005/2006,4,3,3,0,-0.21264881422156812
2004/2005,46,11,2005/2006,5,4,12,8,-Inf
2004/2005,46,12,2005/2006,6,10,13,3,-Inf
2004/2005,46,13,2005/2006,7,12,10,2,-11.512925464970229
2004/2005,46,14,2005/2006,8,21,13,8,-Inf
2004/2005,46,15,2005/2006,9,26,13,13,-Inf
2004/2005,46,16,2005/2006,10,21,8,13,-Inf
2004/2005,46,17,2005/2006,11,30,21,9,-11.512925464970229
2004/2005,46,18,2005/2006,12,45,18,27,-Inf
2004/2005,46,19,2005/2006,13,56,8,48,-Inf
2004/2005,46,20,2005/2006,14,75,7,68,-Inf
2004/2005,46,21,2005/2006,15,83,20,63,-Inf
2004/2005,46,22,2005/2006,16,82,14,68,-Inf
2004/2005,46,23,2005/2006,17,126,14,112,-Inf
2004/2005,46,24,2005/2006,18,119,7,112,-Inf
2004/2005,46,25,2005/2006,19,137,14,123,-Inf
2004/2005,46,26,2005/2006,20,131,10,121,-Inf
2004/2005,46,27,2005/2006,21,112,13,99,-Inf
2004/2005,46,28,2005/2006,22,82,27,55,-Inf
2004/2005,46,29,2005/2006,23,73,13,60,-11.512925464970229
2004/2005,46,30,2005/2006,24,43,18,25,-Inf
2004/2005,46,31,2005/2006,25,55,16,39,-Inf
2004/2005,46,32,2005/2006,26,55,16,39,-Inf
2004/2005,46,33,2005/2006,27,53,20,33,-Inf
2004/2005,46,34,2005/2006,28,46,17,29,-Inf
2004/2005,46,35,2005/2006,29,43,4,39,-Inf
2004/2005,46,36,2005/2006,30,29,15,14,-Inf
2004/2005,46,37,2005/2006,31,22,8,14,-Inf
2004/2005,46,38,2005/2006,32,26,6,20,-Inf
2004/2005,46,39,2005/2006,33,13,12,1,-11.512925464970229
2004/2005,46,40,2005/2006,34,17,15,2,-10.819778284410283
2004/2005,46,41,2005/2006,35,8,11,3,-Inf
2004/2005,46,42,2005/2006,36,13,10,3,-11.512925464970229
2004/2005,46,43,2005/2006,37,10,15,5,-Inf
2004/2005,46,44,2005/2006,38,17,17,0,-0.33718048737157424
2004/2005,46,45,2005/2006,39,19,7,12,-Inf
2004/2005,46,46,2005/2006,40,9,7,2,-Inf
2004/2005,46,47,2005/2006,41,9,8,1,-11.512925464970229
2004/2005,46,48,2005/2006,42,9,9,0,-0.3420115503305379
2004/2005,46,49,2005/2006,43,3,12,9,-Inf
2004/2005,46,50,2005/2006,44,7,12,5,-Inf
2004/2005,46,51,2005/2006,45,7,5,2,-Inf
2004/2005,46,52,2005/2006,46,0,4,4,-Inf
2004/2005,47,6,2005/2006,1,4,10,6,-Inf
2004/2005,47,7,2005/2006,2,2,7,5,-Inf
2004/2005,47,8,2005/2006,3,6,5,1,-10.41431317630212
2004/2005,47,9,2005/2006,4,3,3,0,-0.21692542400097992
2004/2005,47,10,2005/2006,5,4,12,8,-Inf
2004/2005,47,11,2005/2006,6,10,13,3,-Inf
2004/2005,47,12,2005/2006,7,12,10,2,-Inf
2004/2005,47,13,2005/2006,8,21,13,8,-11.512925464970229
2004/2005,47,14,2005/2006,9,26,13,13,-Inf
2004/2005,47,15,2005/2006,10,21,8,13,-Inf
2004/2005,47,16,2005/2006,11,30,21,9,-Inf
2004/2005,47,17,2005/2006,12,45,18,27,-Inf
2004/2005,47,18,2005/2006,13,56,8,48,-Inf
2004/2005,47,19,2005/2006,14,75,7,68,-Inf
2004/2005,47,20,2005/2006,15,83,20,63,-Inf
2004/2005,47,21,2005/2006,16,82,14,68,-Inf
2004/2005,47,22,2005/2006,17,126,14,112,-Inf
2004/2005,47,23,2005/2006,18,119,7,112,-Inf
2004/2005,47,24,2005/2006,19,137,14,123,-Inf
2004/2005,47,25,2005/2006,20,131,10,121,-Inf
2004/2005,47,26,2005/2006,21,112,13,99,-Inf
2004/2005,47,27,2005/2006,22,82,27,55,-Inf
2004/2005,47,28,2005/2006,23,73,13,60,-Inf
2004/2005,47,29,2005/2006,24,43,18,25,-Inf
2004/2005,47,30,2005/2006,25,55,16,39,-Inf
2004/2005,47,31,2005/2006,26,55,16,39,-Inf
2004/2005,47,32,2005/2006,27,53,20,33,-Inf
2004/2005,47,33,2005/2006,28,46,17,29,-Inf
2004/2005,47,34,2005/2006,29,43,4,39,-Inf
2004/2005,47,35,2005/2006,30,29,15,14,-Inf
2004/2005,47,36,2005/2006,31,22,8,14,-Inf
2004/2005,47,37,2005/2006,32,26,6,20,-Inf
2004/2005,47,38,2005/2006,33,13,12,1,-11.512925464970229
2004/2005,47,39,2005/2006,34,17,15,2,-11.512925464970229
2004/2005,47,40,2005/2006,35,8,11,3,-Inf
2004/2005,47,41,2005/2006,36,13,10,3,-Inf
2004/2005,47,42,2005/2006,37,10,15,5,-Inf
2004/2005,47,43,2005/2006,38,17,17,0,-0.3366342497446304
2004/2005,47,44,2005/2006,39,19,7,12,-Inf
2004/2005,47,45,2005/2006,40,9,7,2,-Inf
2004/2005,47,46,2005/2006,41,9,8,1,-Inf
2004/2005,47,47,2005/2006,42,9,9,0,-0.3418567068980529
2004/2005,47,48,2005/2006,43,3,12,9,-Inf
2004/2005,47,49,2005/2006,44,7,12,5,-Inf
2004/2005,47,50,2005/2006,45,7,5,2,-11.512925464970229
2004/2005,47,51,2005/2006,46,0,4,4,-Inf
2004/2005,47,52,2005/2006,47,2,11,9,-Inf
2004/2005,48,5,2005/2006,1,4,10,6,-Inf
2004/2005,48,6,2005/2006,2,2,7,5,-Inf
2004/2005,48,7,2005/2006,3,6,5,1,-10.819778284410283
2004/2005,48,8,2005/2006,4,3,3,0,-0.20117415551022866
2004/2005,48,9,2005/2006,5,4,12,8,-11.512925464970229
2004/2005,48,10,2005/2006,6,10,13,3,-Inf
2004/2005,48,11,2005/2006,7,12,10,2,-Inf
2004/2005,48,12,2005/2006,8,21,13,8,-Inf
2004/2005,48,13,2005/2006,9,26,13,13,-Inf
2004/2005,48,14,2005/2006,10,21,8,13,-Inf
2004/2005,48,15,2005/2006,11,30,21,9,-Inf
2004/2005,48,16,2005/2006,12,45,18,27,-Inf
2004/2005,48,17,2005/2006,13,56,8,48,-Inf
2004/2005,48,18,2005/2006,14,75,7,68,-Inf
2004/2005,48,19,2005/2006,15,83,20,63,-Inf
2004/2005,48,20,2005/2006,16,82,14,68,-Inf
2004/2005,48,21,2005/2006,17,126,14,112,-Inf
2004/2005,48,22,2005/2006,18,119,7,112,-Inf
2004/2005,48,23,2005/2006,19,137,14,123,-Inf
2004/2005,48,24,2005/2006,20,131,10,121,-Inf
2004/2005,48,25,2005/2006,21,112,13,99,-Inf
2004/2005,48,26,2005/2006,22,82,27,55,-Inf
2004/2005,48,27,2005/2006,23,73,13,60,-Inf
2004/2005,48,28,2005/2006,24,43,18,25,-Inf
2004/2005,48,29,2005/2006,25,55,16,39,-Inf
2004/2005,48,30,2005/2006,26,55,16,39,-Inf
2004/2005,48,31,2005/2006,27,53,20,33,-Inf
2004/2005,48,32,2005/2006,28,46,17,29,-Inf
2004/2005,48,33,2005/2006,29,43,4,39,-Inf
2004/2005,48,34,2005/2006,30,29,15,14,-Inf
2004/2005,48,35,2005/2006,31,22,8,14,-Inf
2004/2005,48,36,2005/2006,32,26,6,20,-Inf
2004/2005,48,37,2005/2006,33,13,12,1,-11.512925464970229
2004/2005,48,38,2005/2006,34,17,15,2,-Inf
2004/2005,48,39,2005/2006,35,8,11,3,-11.512925464970229
2004/2005,48,40,2005/2006,36,13,10,3,-Inf
2004/2005,48,41,2005/2006,37,10,15,5,-Inf
2004/2005,48,42,2005/2006,38,17,17,0,-0.33736263290635904
2004/2005,48,43,2005/2006,39,19,7,12,-Inf
2004/2005,48,44,2005/2006,40,9,7,2,-Inf
2004/2005,48,45,2005/2006,41,9,8,1,-11.512925464970229
2004/2005,48,46,2005/2006,42,9,9,0,-0.34025337612787254
2004/2005,48,47,2005/2006,43,3,12,9,-Inf
2004/2005,48,48,2005/2006,44,7,12,5,-Inf
2004/2005,48,49,2005/2006,45,7,5,2,-11.512925464970229
2004/2005,48,50,2005/2006,46,0,4,4,-11.512925464970229
2004/2005,48,51,2005/2006,47,2,11,9,-Inf
2004/2005,48,52,2005/2006,48,3,4,1,-Inf
2004/2005,49,4,2005/2006,1,4,10,6,-Inf
2004/2005,49,5,2005/2006,2,2,7,5,-Inf
2004/2005,49,6,2005/2006,3,6,5,1,-11.512925464970229
2004/2005,49,7,2005/2006,4,3,3,0,-0.17819408653071633
2004/2005,49,8,2005/2006,5,4,12,8,-Inf
2004/2005,49,9,2005/2006,6,10,13,3,-Inf
2004/2005,49,10,2005/2006,7,12,10,2,-11.512925464970229
2004/2005,49,11,2005/2006,8,21,13,8,-Inf
2004/2005,49,12,2005/2006,9,26,13,13,-Inf
2004/2005,49,13,2005/2006,10,21,8,13,-Inf
2004/2005,49,14,2005/2006,11,30,21,9,-Inf
2004/2005,49,15,2005/2006,12,45,18,27,-Inf
2004/2005,49,16,2005/2006,13,56,8,48,-Inf
2004/2005,49,17,2005/2006,14,75,7,68,-Inf
2004/2005,49,18,2005/2006,15,83,20,63,-Inf
2004/2005,49,19,2005/2006,16,82,14,68,-Inf
2004/2005,49,20,2005/2006,17,126,14,112,-Inf
2004/2005,49,21,2005/2006,18,119,7,112,-Inf
2004/2005,49,22,2005/2006,19,137,14,123,-Inf
2004/2005,49,23,2005/2006,20,131,10,121,-Inf
2004/2005,49,24,2005/2006,21,112,13,99,-Inf
2004/2005,49,25,2005/2006,22,82,27,55,-Inf
2004/2005,49,26,2005/2006,23,73,13,60,-Inf
2004/2005,49,27,2005/2006,24,43,18,25,-Inf
2004/2005,49,28,2005/2006,25,55,16,39,-Inf
2004/2005,49,29,2005/2006,26,55,16,39,-Inf
2004/2005,49,30,2005/2006,27,53,20,33,-Inf
2004/2005,49,31,2005/2006,28,46,17,29,-Inf
2004/2005,49,32,2005/2006,29,43,4,39,-Inf
2004/2005,49,33,2005/2006,30,29,15,14,-Inf
2004/2005,49,34,2005/2006,31,22,8,14,-Inf
2004/2005,49,35,2005/2006,32,26,6,20,-Inf
2004/2005,49,36,2005/2006,33,13,12,1,-Inf
2004/2005,49,37,2005/2006,34,17,15,2,-Inf
2004/2005,49,38,2005/2006,35,8,11,3,-10.819778284410283
2004/2005,49,39,2005/2006,36,13,10,3,-Inf
2004/2005,49,40,2005/2006,37,10,15,5,-Inf
2004/2005,49,41,2005/2006,38,17,17,0,-0.33429860068037165
2004/2005,49,42,2005/2006,39,19,7,12,-Inf
2004/2005,49,43,2005/2006,40,9,7,2,-10.819778284410283
2004/2005,49,44,2005/2006,41,9,8,1,-10.819778284410283
2004/2005,49,45,2005/2006,42,9,9,0,-0.3407453533943894
2004/2005,49,46,2005/2006,43,3,12,9,-Inf
2004/2005,49,47,2005/2006,44,7,12,5,-Inf
2004/2005,49,48,2005/2006,45,7,5,2,-Inf
2004/2005,49,49,2005/2006,46,0,4,4,-Inf
2004/2005,49,50,2005/2006,47,2,11,9,-Inf
2004/2005,49,51,2005/2006,48,3,4,1,-11.512925464970229
2004/2005,49,52,2005/2006,49,3,5,2,-Inf
2004/2005,4,49,2005/2006,1,4,10,6,-Inf
2004/2005,4,50,2005/2006,2,2,7,5,-Inf
2004/2005,4,51,2005/2006,3,6,5,1,-11.512925464970229
2004/2005,4,52,2005/2006,4,3,3,0,-0.3452123201192414
2004/2005,50,3,2005/2006,1,4,10,6,-Inf
2004/2005,50,4,2005/2006,2,2,7,5,-Inf
2004/2005,50,5,2005/2006,3,6,5,1,-11.512925464970229
2004/2005,50,6,2005/2006,4,3,3,0,-0.22150739055553004
2004/2005,50,7,2005/2006,5,4,12,8,-Inf
2004/2005,50,8,2005/2006,6,10,13,3,-Inf
2004/2005,50,9,2005/2006,7,12,10,2,-11.512925464970229
2004/2005,50,10,2005/2006,8,21,13,8,-Inf
2004/2005,50,11,2005/2006,9,26,13,13,-Inf
2004/2005,50,12,2005/2006,10,21,8,13,-Inf
2004/2005,50,13,2005/2006,11,30,21,9,-Inf
2004/2005,50,14,2005/2006,12,45,18,27,-Inf
2004/2005,50,15,2005/2006,13,56,8,48,-Inf
2004/2005,50,16,2005/2006,14,75,7,68,-Inf
2004/2005,50,17,2005/2006,15,83,20,63,-Inf
2004/2005,50,18,2005/2006,16,82,14,68,-Inf
2004/2005,50,19,2005/2006,17,126,14,112,-Inf
2004/2005,50,20,2005/2006,18,119,7,112,-Inf
2004/2005,50,21,2005/2006,19,137,14,123,-Inf
2004/2005,50,22,2005/2006,20,131,10,121,-Inf
2004/2005,50,23,2005/2006,21,112,13,99,-Inf
2004/2005,50,24,2005/2006,22,82,27,55,-Inf
2004/2005,50,25,2005/2006,23,73,13,60,-Inf
2004/2005,50,26,2005/2006,24,43,18,25,-Inf
2004/2005,50,27,2005/2006,25,55,16,39,-Inf
2004/2005,50,28,2005/2006,26,55,16,39,-Inf
2004/2005,50,29,2005/2006,27,53,20,33,-Inf
2004/2005,50,30,2005/2006,28,46,17,29,-Inf
2004/2005,50,31,2005/2006,29,43,4,39,-11.512925464970229
2004/2005,50,32,2005/2006,30,29,15,14,-Inf
2004/2005,50,33,2005/2006,31,22,8,14,-Inf
2004/2005,50,34,2005/2006,32,26,6,20,-Inf
2004/2005,50,35,2005/2006,33,13,12,1,-11.512925464970229
2004/2005,50,36,2005/2006,34,17,15,2,-Inf
2004/2005,50,37,2005/2006,35,8,11,3,-Inf
2004/2005,50,38,2005/2006,36,13,10,3,-Inf
2004/2005,50,39,2005/2006,37,10,15,5,-Inf
2004/2005,50,40,2005/2006,38,17,17,0,-0.3382177591596758
2004/2005,50,41,2005/2006,39,19,7,12,-Inf
2004/2005,50,42,2005/2006,40,9,7,2,-Inf
2004/2005,50,43,2005/2006,41,9,8,1,-Inf
2004/2005,50,44,2005/2006,42,9,9,0,-0.34008475391149595
2004/2005,50,45,2005/2006,43,3,12,9,-Inf
2004/2005,50,46,2005/2006,44,7,12,5,-11.512925464970229
2004/2005,50,47,2005/2006,45,7,5,2,-Inf
2004/2005,50,48,2005/2006,46,0,4,4,-Inf
2004/2005,50,49,2005/2006,47,2,11,9,-Inf
2004/2005,50,50,2005/2006,48,3,4,1,-11.512925464970229
2004/2005,50,51,2005/2006,49,3,5,2,-11.512925464970229
2004/2005,50,52,2005/2006,50,1,7,6,-11.512925464970229
2004/2005,51,2,2005/2006,1,4,10,6,-Inf
2004/2005,51,3,2005/2006,2,2,7,5,-Inf
2004/2005,51,4,2005/2006,3,6,5,1,-Inf
2004/2005,51,5,2005/2006,4,3,3,0,-0.14119496866704218
2004/2005,51,6,2005/2006,5,4,12,8,-11.512925464970229
2004/2005,51,7,2005/2006,6,10,13,3,-Inf
2004/2005,51,8,2005/2006,7,12,10,2,-Inf
2004/2005,51,9,2005/2006,8,21,13,8,-Inf
2004/2005,51,10,2005/2006,9,26,13,13,-Inf
2004/2005,51,11,2005/2006,10,21,8,13,-Inf
2004/2005,51,12,2005/2006,11,30,21,9,-Inf
2004/2005,51,13,2005/2006,12,45,18,27,-Inf
2004/2005,51,14,2005/2006,13,56,8,48,-Inf
2004/2005,51,15,2005/2006,14,75,7,68,-Inf
2004/2005,51,16,2005/2006,15,83,20,63,-Inf
2004/2005,51,17,2005/2006,16,82,14,68,-Inf
2004/2005,51,18,2005/2006,17,126,14,112,-Inf
2004/2005,51,19,2005/2006,18,119,7,112,-Inf
2004/2005,51,20,2005/2006,19,137,14,123,-Inf
2004/2005,51,21,2005/2006,20,131,10,121,-Inf
2004/2005,51,22,2005/2006,21,112,13,99,-Inf
2004/2005,51,23,2005/2006,22,82,27,55,-Inf
2004/2005,51,24,2005/2006,23,73,13,60,-Inf
2004/2005,51,25,2005/2006,24,43,18,25,-Inf
2004/2005,51,26,2005/2006,25,55,16,39,-Inf
2004/2005,51,27,2005/2006,26,55,16,39,-Inf
2004/2005,51,28,2005/2006,27,53,20,33,-Inf
2004/2005,51,29,2005/2006,28,46,17,29,-Inf
2004/2005,51,30,2005/2006,29,43,4,39,-Inf
2004/2005,51,31,2005/2006,30,29,15,14,-Inf
2004/2005,51,32,2005/2006,31,22,8,14,-Inf
2004/2005,51,33,2005/2006,32,26,6,20,-Inf
2004/2005,51,34,2005/2006,33,13,12,1,-11.512925464970229
2004/2005,51,35,2005/2006,34,17,15,2,-Inf
2004/2005,51,36,2005/2006,35,8,11,3,-Inf
2004/2005,51,37,2005/2006,36,13,10,3,-Inf
2004/2005,51,38,2005/2006,37,10,15,5,-Inf
2004/2005,51,39,2005/2006,38,17,17,0,-0.3290180879470732
2004/2005,51,40,2005/2006,39,19,7,12,-Inf
2004/2005,51,41,2005/2006,40,9,7,2,-Inf
2004/2005,51,42,2005/2006,41,9,8,1,-11.512925464970229
2004/2005,51,43,2005/2006,42,9,9,0,-0.3356265942775085
2004/2005,51,44,2005/2006,43,3,12,9,-11.512925464970229
2004/2005,51,45,2005/2006,44,7,12,5,-Inf
2004/2005,51,46,2005/2006,45,7,5,2,-11.512925464970229
2004/2005,51,47,2005/2006,46,0,4,4,-Inf
2004/2005,51,48,2005/2006,47,2,11,9,-Inf
2004/2005,51,49,2005/2006,48,3,4,1,-11.512925464970229
2004/2005,51,50,2005/2006,49,3,5,2,-10.819778284410283
2004/2005,51,51,2005/2006,50,1,7,6,-Inf
2004/2005,51,52,2005/2006,51,3,1,2,-Inf
2004/2005,52,1,2005/2006,1,4,10,6,-Inf
2004/2005,52,2,2005/2006,2,2,7,5,-Inf
2004/2005,52,3,2005/2006,3,6,5,1,-11.512925464970229
2004/2005,52,4,2005/2006,4,3,3,0,-0.21560950366012932
2004/2005,52,5,2005/2006,5,4,12,8,-Inf
2004/2005,52,6,2005/2006,6,10,13,3,-Inf
2004/2005,52,7,2005/2006,7,12,10,2,-Inf
2004/2005,52,8,2005/2006,8,21,13,8,-Inf
2004/2005,52,9,2005/2006,9,26,13,13,-Inf
2004/2005,52,10,2005/2006,10,21,8,13,-Inf
2004/2005,52,11,2005/2006,11,30,21,9,-Inf
2004/2005,52,12,2005/2006,12,45,18,27,-Inf
2004/2005,52,13,2005/2006,13,56,8,48,-Inf
2004/2005,52,14,2005/2006,14,75,7,68,-Inf
2004/2005,52,15,2005/2006,15,83,20,63,-Inf
2004/2005,52,16,2005/2006,16,82,14,68,-Inf
2004/2005,52,17,2005/2006,17,126,14,112,-Inf
2004/2005,52,18,2005/2006,18,119,7,112,-11.512925464970229
2004/2005,52,19,2005/2006,19,137,14,123,-Inf
2004/2005,52,20,2005/2006,20,131,10,121,-Inf
2004/2005,52,21,2005/2006,21,112,13,99,-Inf
2004/2005,52,22,2005/2006,22,82,27,55,-Inf
2004/2005,52,23,2005/2006,23,73,13,60,-Inf
2004/2005,52,24,2005/2006,24,43,18,25,-Inf
2004/2005,52,25,2005/2006,25,55,16,39,-Inf
2004/2005,52,26,2005/2006,26,55,16,39,-Inf
2004/2005,52,27,2005/2006,27,53,20,33,-Inf
2004/2005,52,28,2005/2006,28,46,17,29,-Inf
2004/2005,52,29,2005/2006,29,43,4,39,-Inf
2004/2005,52,30,2005/2006,30,29,15,14,-Inf
2004/2005,52,31,2005/2006,31,22,8,14,-Inf
2004/2005,52,32,2005/2006,32,26,6,20,-11.512925464970229
2004/2005,52,33,2005/2006,33,13,12,1,-11.512925464970229
2004/2005,52,34,2005/2006,34,17,15,2,-Inf
2004/2005,52,35,2005/2006,35,8,11,3,-11.512925464970229
2004/2005,52,36,2005/2006,36,13,10,3,-11.512925464970229
2004/2005,52,37,2005/2006,37,10,15,5,-Inf
2004/2005,52,38,2005/2006,38,17,17,0,-0.33214959272252464
2004/2005,52,39,2005/2006,39,19,7,12,-Inf
2004/2005,52,40,2005/2006,40,9,7,2,-Inf
2004/2005,52,41,2005/2006,41,9,8,1,-Inf
2004/2005,52,42,2005/2006,42,9,9,0,-0.34057664820630507
2004/2005,52,43,2005/2006,43,3,12,9,-11.512925464970229
2004/2005,52,44,2005/2006,44,7,12,5,-Inf
2004/2005,52,45,2005/2006,45,7,5,2,-11.512925464970229
2004/2005,52,46,2005/2006,46,0,4,4,-Inf
2004/2005,52,47,2005/2006,47,2,11,9,-Inf
2004/2005,52,48,2005/2006,48,3,4,1,-10.819778284410283
2004/2005,52,49,2005/2006,49,3,5,2,-11.512925464970229
2004/2005,52,50,2005/2006,50,1,7,6,-Inf
2004/2005,52,51,2005/2006,51,3,1,2,-Inf
2004/2005,52,52,2005/2006,52,3,1,2,-Inf
2004/2005,5,48,2005/2006,1,4,10,6,-Inf
2004/2005,5,49,2005/2006,2,2,7,5,-Inf
2004/2005,5,50,2005/2006,3,6,5,1,-11.512925464970229
2004/2005,5,51,2005/2006,4,3,3,0,-0.342462140329431
2004/2005,5,52,2005/2006,5,4,12,8,-Inf
2004/2005,6,47,2005/2006,1,4,10,6,-Inf
2004/2005,6,48,2005/2006,2,2,7,5,-Inf
2004/2005,6,49,2005/2006,3,6,5,1,-10.819778284410283
2004/2005,6,50,2005/2006,4,3,3,0,-0.34477460610893473
2004/2005,6,51,2005/2006,5,4,12,8,-Inf
2004/2005,6,52,2005/2006,6,10,13,3,-11.512925464970229
2004/2005,7,46,2005/2006,1,4,10,6,-Inf
2004/2005,7,47,2005/2006,2,2,7,5,-Inf
2004/2005,7,48,2005/2006,3,6,5,1,-11.512925464970229
2004/2005,7,49,2005/2006,4,3,3,0,-0.3395088424454755
2004/2005,7,50,2005/2006,5,4,12,8,-Inf
2004/2005,7,51,2005/2006,6,10,13,3,-11.512925464970229
2004/2005,7,52,2005/2006,7,12,10,2,-11.512925464970229
2004/2005,8,45,2005/2006,1,4,10,6,-Inf
2004/2005,8,46,2005/2006,2,2,7,5,-Inf
2004/2005,8,47,2005/2006,3,6,5,1,-10.41431317630212
2004/2005,8,48,2005/2006,4,3,3,0,-0.3409422120926653
2004/2005,8,49,2005/2006,5,4,12,8,-Inf
2004/2005,8,50,2005/2006,6,10,13,3,-Inf
2004/2005,8,51,2005/2006,7,12,10,2,-Inf
2004/2005,8,52,2005/2006,8,21,13,8,-Inf
2004/2005,9,44,2005/2006,1,4,10,6,-Inf
2004/2005,9,45,2005/2006,2,2,7,5,-Inf
2004/2005,9,46,2005/2006,3,6,5,1,-10.819778284410283
2004/2005,9,47,2005/2006,4,3,3,0,-0.34066099724266863
2004/2005,9,48,2005/2006,5,4,12,8,-Inf
2004/2005,9,49,2005/2006,6,10,13,3,-Inf
2004/2005,9,50,2005/2006,7,12,10,2,-11.512925464970229
2004/2005,9,51,2005/2006,8,21,13,8,-Inf
2004/2005,9,52,2005/2006,9,26,13,13,-Inf
2005/2006,10,1,2005/2006,11,30,21,9,-Inf
2005/2006,10,2,2005/2006,12,45,18,27,-Inf
2005/2006,10,3,2005/2006,13,56,8,48,-Inf
2005/2006,10,4,2005/2006,14,75,7,68,-Inf
2005/2006,10,5,2005/2006,15,83,20,63,-Inf
2005/2006,10,6,2005/2006,16,82,14,68,-Inf
2005/2006,10,7,2005/2006,17,126,14,112,-Inf
2005/2006,10,8,2005/2006,18,119,7,112,-Inf
2005/2006,10,9,2005/2006,19,137,14,123,-Inf
2005/2006,10,10,2005/2006,20,131,10,121,-Inf
2005/2006,10,11,2005/2006,21,112,13,99,-Inf
2005/2006,10,12,2005/2006,22,82,27,55,-Inf
2005/2006,10,13,2005/2006,23,73,13,60,-Inf
2005/2006,10,14,2005/2006,24,43,18,25,-Inf
2005/2006,10,15,2005/2006,25,55,16,39,-Inf
2005/2006,10,16,2005/2006,26,55,16,39,-Inf
2005/2006,10,17,2005/2006,27,53,20,33,-Inf
2005/2006,10,18,2005/2006,28,46,17,29,-11.512925464970229
2005/2006,10,19,2005/2006,29,43,4,39,-Inf
2005/2006,10,20,2005/2006,30,29,15,14,-Inf
2005/2006,10,21,2005/2006,31,22,8,14,-Inf
2005/2006,10,22,2005/2006,32,26,6,20,-Inf
2005/2006,10,23,2005/2006,33,13,12,1,-11.512925464970229
2005/2006,10,24,2005/2006,34,17,15,2,-10.819778284410283
2005/2006,10,25,2005/2006,35,8,11,3,-Inf
2005/2006,10,26,2005/2006,36,13,10,3,-Inf
2005/2006,10,27,2005/2006,37,10,15,5,-Inf
2005/2006,10,28,2005/2006,38,17,17,0,-0.3519148625520714
2005/2006,10,29,2005/2006,39,19,7,12,-Inf
2005/2006,10,30,2005/2006,40,9,7,2,-Inf
2005/2006,10,31,2005/2006,41,9,8,1,-10.819778284410283
2005/2006,10,32,2005/2006,42,9,9,0,-0.35002567086228353
2005/2006,10,33,2005/2006,43,3,12,9,-10.819778284410283
2005/2006,10,34,2005/2006,44,7,12,5,-Inf
2005/2006,10,35,2005/2006,45,7,5,2,-10.819778284410283
2005/2006,10,36,2005/2006,46,0,4,4,-Inf
2005/2006,10,37,2005/2006,47,2,11,9,-Inf
2005/2006,10,38,2005/2006,48,3,4,1,-Inf
2005/2006,10,39,2005/2006,49,3,5,2,-11.512925464970229
2005/2006,10,40,2005/2006,50,1,7,6,-Inf
2005/2006,10,41,2005/2006,51,3,1,2,-Inf
2005/2006,10,42,2005/2006,52,3,1,2,-11.512925464970229
2005/2006,10,43,2006/2007,1,3,4,1,-11.512925464970229
2005/2006,10,44,2006/2007,2,7,2,5,-Inf
2005/2006,10,45,2006/2007,3,3,6,3,-Inf
2005/2006,10,46,2006/2007,4,5,3,2,-11.512925464970229
2005/2006,10,47,2006/2007,5,11,4,7,-Inf
2005/2006,10,48,2006/2007,6,5,10,5,-Inf
2005/2006,10,49,2006/2007,7,5,12,7,-11.512925464970229
2005/2006,10,50,2006/2007,8,6,21,15,-Inf
2005/2006,10,51,2006/2007,9,6,26,20,-Inf
2005/2006,10,52,2006/2007,10,4,21,17,-Inf
2005/2006,11,1,2005/2006,12,45,18,27,-Inf
2005/2006,11,2,2005/2006,13,56,8,48,-Inf
2005/2006,11,3,2005/2006,14,75,7,68,-Inf
2005/2006,11,4,2005/2006,15,83,20,63,-Inf
2005/2006,11,5,2005/2006,16,82,14,68,-Inf
2005/2006,11,6,2005/2006,17,126,14,112,-Inf
2005/2006,11,7,2005/2006,18,119,7,112,-Inf
2005/2006,11,8,2005/2006,19,137,14,123,-Inf
2005/2006,11,9,2005/2006,20,131,10,121,-Inf
2005/2006,11,10,2005/2006,21,112,13,99,-Inf
2005/2006,11,11,2005/2006,22,82,27,55,-Inf
2005/2006,11,12,2005/2006,23,73,13,60,-Inf
2005/2006,11,13,2005/2006,24,43,18,25,-Inf
2005/2006,11,14,2005/2006,25,55,16,39,-Inf
2005/2006,11,15,2005/2006,26,55,16,39,-Inf
2005/2006,11,16,2005/2006,27,53,20,33,-Inf
2005/2006,11,17,2005/2006,28,46,17,29,-Inf
2005/2006,11,18,2005/2006,29,43,4,39,-Inf
2005/2006,11,19,2005/2006,30,29,15,14,-Inf
2005/2006,11,20,2005/2006,31,22,8,14,-Inf
2005/2006,11,21,2005/2006,32,26,6,20,-Inf
2005/2006,11,22,2005/2006,33,13,12,1,-11.512925464970229
2005/2006,11,23,2005/2006,34,17,15,2,-11.512925464970229
2005/2006,11,24,2005/2006,35,8,11,3,-11.512925464970229
2005/2006,11,25,2005/2006,36,13,10,3,-Inf
2005/2006,11,26,2005/2006,37,10,15,5,-Inf
2005/2006,11,27,2005/2006,38,17,17,0,-0.3678803477808934
2005/2006,11,28,2005/2006,39,19,7,12,-11.512925464970229
2005/2006,11,29,2005/2006,40,9,7,2,-Inf
2005/2006,11,30,2005/2006,41,9,8,1,-10.819778284410283
2005/2006,11,31,2005/2006,42,9,9,0,-0.3630380024682687
2005/2006,11,32,2005/2006,43,3,12,9,-Inf
2005/2006,11,33,2005/2006,44,7,12,5,-Inf
2005/2006,11,34,2005/2006,45,7,5,2,-11.512925464970229
2005/2006,11,35,2005/2006,46,0,4,4,-Inf
2005/2006,11,36,2005/2006,47,2,11,9,-Inf
2005/2006,11,37,2005/2006,48,3,4,1,-Inf
2005/2006,11,38,2005/2006,49,3,5,2,-Inf
2005/2006,11,39,2005/2006,50,1,7,6,-Inf
2005/2006,11,40,2005/2006,51,3,1,2,-Inf
2005/2006,11,41,2005/2006,52,3,1,2,-10.41431317630212
2005/2006,11,42,2006/2007,1,3,4,1,-Inf
2005/2006,11,43,2006/2007,2,7,2,5,-Inf
2005/2006,11,44,2006/2007,3,3,6,3,-Inf
2005/2006,11,45,2006/2007,4,5,3,2,-Inf
2005/2006,11,46,2006/2007,5,11,4,7,-Inf
2005/2006,11,47,2006/2007,6,5,10,5,-Inf
2005/2006,11,48,2006/2007,7,5,12,7,-Inf
2005/2006,11,49,2006/2007,8,6,21,15,-Inf
2005/2006,11,50,2006/2007,9,6,26,20,-Inf
2005/2006,11,51,2006/2007,10,4,21,17,-Inf
2005/2006,11,52,2006/2007,11,4,30,26,-Inf
2005/2006,12,1,2005/2006,13,56,8,48,-Inf
2005/2006,12,2,2005/2006,14,75,7,68,-Inf
2005/2006,12,3,2005/2006,15,83,20,63,-Inf
2005/2006,12,4,2005/2006,16,82,14,68,-Inf
2005/2006,12,5,2005/2006,17,126,14,112,-Inf
2005/2006,12,6,2005/2006,18,119,7,112,-Inf
2005/2006,12,7,2005/2006,19,137,14,123,-11.512925464970229
2005/2006,12,8,2005/2006,20,131,10,121,-Inf
2005/2006,12,9,2005/2006,21,112,13,99,-Inf
2005/2006,12,10,2005/2006,22,82,27,55,-Inf
2005/2006,12,11,2005/2006,23,73,13,60,-Inf
2005/2006,12,12,2005/2006,24,43,18,25,-Inf
2005/2006,12,13,2005/2006,25,55,16,39,-Inf
2005/2006,12,14,2005/2006,26,55,16,39,-Inf
2005/2006,12,15,2005/2006,27,53,20,33,-Inf
2005/2006,12,16,2005/2006,28,46,17,29,-Inf
2005/2006,12,17,2005/2006,29,43,4,39,-Inf
2005/2006,12,18,2005/2006,30,29,15,14,-11.512925464970229
2005/2006,12,19,2005/2006,31,22,8,14,-Inf
2005/2006,12,20,2005/2006,32,26,6,20,-11.512925464970229
2005/2006,12,21,2005/2006,33,13,12,1,-11.512925464970229
2005/2006,12,22,2005/2006,34,17,15,2,-Inf
2005/2006,12,23,2005/2006,35,8,11,3,-Inf
2005/2006,12,24,2005/2006,36,13,10,3,-11.512925464970229
2005/2006,12,25,2005/2006,37,10,15,5,-Inf
2005/2006,12,26,2005/2006,38,17,17,0,-0.3707738683182349
2005/2006,12,27,2005/2006,39,19,7,12,-Inf
2005/2006,12,28,2005/2006,40,9,7,2,-Inf
2005/2006,12,29,2005/2006,41,9,8,1,-Inf
2005/2006,12,30,2005/2006,42,9,9,0,-0.364563116787739
2005/2006,12,31,2005/2006,43,3,12,9,-Inf
2005/2006,12,32,2005/2006,44,7,12,5,-Inf
2005/2006,12,33,2005/2006,45,7,5,2,-11.512925464970229
2005/2006,12,34,2005/2006,46,0,4,4,-11.512925464970229
2005/2006,12,35,2005/2006,47,2,11,9,-Inf
2005/2006,12,36,2005/2006,48,3,4,1,-11.512925464970229
2005/2006,12,37,2005/2006,49,3,5,2,-11.512925464970229
2005/2006,12,38,2005/2006,50,1,7,6,-Inf
2005/2006,12,39,2005/2006,51,3,1,2,-11.512925464970229
2005/2006,12,40,2005/2006,52,3,1,2,-Inf
2005/2006,12,41,2006/2007,1,3,4,1,-11.512925464970229
2005/2006,12,42,2006/2007,2,7,2,5,-Inf
2005/2006,12,43,2006/2007,3,3,6,3,-Inf
2005/2006,12,44,2006/2007,4,5,3,2,-Inf
2005/2006,12,45,2006/2007,5,11,4,7,-Inf
2005/2006,12,46,2006/2007,6,5,10,5,-Inf
2005/2006,12,47,2006/2007,7,5,12,7,-Inf
2005/2006,12,48,2006/2007,8,6,21,15,-Inf
2005/2006,12,49,2006/2007,9,6,26,20,-Inf
2005/2006,12,50,2006/2007,10,4,21,17,-Inf
2005/2006,12,51,2006/2007,11,4,30,26,-Inf
2005/2006,12,52,2006/2007,12,8,45,37,-Inf
2005/2006,13,1,2005/2006,14,75,7,68,-Inf
2005/2006,13,2,2005/2006,15,83,20,63,-Inf
2005/2006,13,3,2005/2006,16,82,14,68,-Inf
2005/2006,13,4,2005/2006,17,126,14,112,-Inf
2005/2006,13,5,2005/2006,18,119,7,112,-Inf
2005/2006,13,6,2005/2006,19,137,14,123,-Inf
2005/2006,13,7,2005/2006,20,131,10,121,-Inf
2005/2006,13,8,2005/2006,21,112,13,99,-Inf
2005/2006,13,9,2005/2006,22,82,27,55,-Inf
2005/2006,13,10,2005/2006,23,73,13,60,-Inf
2005/2006,13,11,2005/2006,24,43,18,25,-Inf
2005/2006,13,12,2005/2006,25,55,16,39,-Inf
2005/2006,13,13,2005/2006,26,55,16,39,-Inf
2005/2006,13,14,2005/2006,27,53,20,33,-Inf
2005/2006,13,15,2005/2006,28,46,17,29,-Inf
2005/2006,13,16,2005/2006,29,43,4,39,-Inf
2005/2006,13,17,2005/2006,30,29,15,14,-Inf
2005/2006,13,18,2005/2006,31,22,8,14,-Inf
2005/2006,13,19,2005/2006,32,26,6,20,-Inf
2005/2006,13,20,2005/2006,33,13,12,1,-10.126631103850338
2005/2006,13,21,2005/2006,34,17,15,2,-10.819778284410283
2005/2006,13,22,2005/2006,35,8,11,3,-Inf
2005/2006,13,23,2005/2006,36,13,10,3,-Inf
2005/2006,13,24,2005/2006,37,10,15,5,-Inf
2005/2006,13,25,2005/2006,38,17,17,0,-0.3703972368476709
2005/2006,13,26,2005/2006,39,19,7,12,-Inf
2005/2006,13,27,2005/2006,40,9,7,2,-Inf
2005/2006,13,28,2005/2006,41,9,8,1,-10.41431317630212
2005/2006,13,29,2005/2006,42,9,9,0,-0.36457751573949615
2005/2006,13,30,2005/2006,43,3,12,9,-11.512925464970229
2005/2006,13,31,2005/2006,44,7,12,5,-11.512925464970229
2005/2006,13,32,2005/2006,45,7,5,2,-10.819778284410283
2005/2006,13,33,2005/2006,46,0,4,4,-Inf
2005/2006,13,34,2005/2006,47,2,11,9,-Inf
2005/2006,13,35,2005/2006,48,3,4,1,-11.512925464970229
2005/2006,13,36,2005/2006,49,3,5,2,-Inf
2005/2006,13,37,2005/2006,50,1,7,6,-Inf
2005/2006,13,38,2005/2006,51,3,1,2,-Inf
2005/2006,13,39,2005/2006,52,3,1,2,-11.512925464970229
2005/2006,13,40,2006/2007,1,3,4,1,-Inf
2005/2006,13,41,2006/2007,2,7,2,5,-Inf
2005/2006,13,42,2006/2007,3,3,6,3,-Inf
2005/2006,13,43,2006/2007,4,5,3,2,-Inf
2005/2006,13,44,2006/2007,5,11,4,7,-Inf
2005/2006,13,45,2006/2007,6,5,10,5,-Inf
2005/2006,13,46,2006/2007,7,5,12,7,-Inf
2005/2006,13,47,2006/2007,8,6,21,15,-Inf
2005/2006,13,48,2006/2007,9,6,26,20,-Inf
2005/2006,13,49,2006/2007,10,4,21,17,-Inf
2005/2006,13,50,2006/2007,11,4,30,26,-Inf
2005/2006,13,51,2006/2007,12,8,45,37,-Inf
2005/2006,13,52,2006/2007,13,14,56,42,-Inf
2005/2006,14,1,2005/2006,15,83,20,63,-Inf
2005/2006,14,2,2005/2006,16,82,14,68,-Inf
2005/2006,14,3,2005/2006,17,126,14,112,-Inf
2005/2006,14,4,2005/2006,18,119,7,112,-Inf
2005/2006,14,5,2005/2006,19,137,14,123,-Inf
2005/2006,14,6,2005/2006,20,131,10,121,-Inf
2005/2006,14,7,2005/2006,21,112,13,99,-Inf
2005/2006,14,8,2005/2006,22,82,27,55,-Inf
2005/2006,14,9,2005/2006,23,73,13,60,-11.512925464970229
2005/2006,14,10,2005/2006,24,43,18,25,-Inf
2005/2006,14,11,2005/2006,25,55,16,39,-Inf
2005/2006,14,12,2005/2006,26,55,16,39,-Inf
2005/2006,14,13,2005/2006,27,53,20,33,-Inf
2005/2006,14,14,2005/2006,28,46,17,29,-Inf
2005/2006,14,15,2005/2006,29,43,4,39,-Inf
2005/2006,14,16,2005/2006,30,29,15,14,-Inf
2005/2006,14,17,2005/2006,31,22,8,14,-Inf
2005/2006,14,18,2005/2006,32,26,6,20,-Inf
2005/2006,14,19,2005/2006,33,13,12,1,-10.126631103850338
2005/2006,14,20,2005/2006,34,17,15,2,-11.512925464970229
2005/2006,14,21,2005/2006,35,8,11,3,-11.512925464970229
2005/2006,14,22,2005/2006,36,13,10,3,-Inf
2005/2006,14,23,2005/2006,37,10,15,5,-Inf
2005/2006,14,24,2005/2006,38,17,17,0,-0.3720061543644988
2005/2006,14,25,2005/2006,39,19,7,12,-Inf
2005/2006,14,26,2005/2006,40,9,7,2,-Inf
2005/2006,14,27,2005/2006,41,9,8,1,-10.41431317630212
2005/2006,14,28,2005/2006,42,9,9,0,-0.36730264701381543
2005/2006,14,29,2005/2006,43,3,12,9,-Inf
2005/2006,14,30,2005/2006,44,7,12,5,-Inf
2005/2006,14,31,2005/2006,45,7,5,2,-11.512925464970229
2005/2006,14,32,2005/2006,46,0,4,4,-Inf
2005/2006,14,33,2005/2006,47,2,11,9,-Inf
2005/2006,14,34,2005/2006,48,3,4,1,-11.512925464970229
2005/2006,14,35,2005/2006,49,3,5,2,-Inf
2005/2006,14,36,2005/2006,50,1,7,6,-Inf
2005/2006,14,37,2005/2006,51,3,1,2,-10.819778284410283
2005/2006,14,38,2005/2006,52,3,1,2,-Inf
2005/2006,14,39,2006/2007,1,3,4,1,-Inf
2005/2006,14,40,2006/2007,2,7,2,5,-Inf
2005/2006,14,41,2006/2007,3,3,6,3,-Inf
2005/2006,14,42,2006/2007,4,5,3,2,-Inf
2005/2006,14,43,2006/2007,5,11,4,7,-Inf
2005/2006,14,44,2006/2007,6,5,10,5,-Inf
2005/2006,14,45,2006/2007,7,5,12,7,-Inf
2005/2006,14,46,2006/2007,8,6,21,15,-Inf
2005/2006,14,47,2006/2007,9,6,26,20,-Inf
2005/2006,14,48,2006/2007,10,4,21,17,-Inf
2005/2006,14,49,2006/2007,11,4,30,26,-Inf
2005/2006,14,50,2006/2007,12,8,45,37,-Inf
2005/2006,14,51,2006/2007,13,14,56,42,-11.512925464970229
2005/2006,14,52,2006/2007,14,12,75,63,-Inf
2005/2006,15,1,2005/2006,16,82,14,68,-Inf
2005/2006,15,2,2005/2006,17,126,14,112,-Inf
2005/2006,15,3,2005/2006,18,119,7,112,-Inf
2005/2006,15,4,2005/2006,19,137,14,123,-Inf
2005/2006,15,5,2005/2006,20,131,10,121,-Inf
2005/2006,15,6,2005/2006,21,112,13,99,-Inf
2005/2006,15,7,2005/2006,22,82,27,55,-Inf
2005/2006,15,8,2005/2006,23,73,13,60,-Inf
2005/2006,15,9,2005/2006,24,43,18,25,-Inf
2005/2006,15,10,2005/2006,25,55,16,39,-Inf
2005/2006,15,11,2005/2006,26,55,16,39,-Inf
2005/2006,15,12,2005/2006,27,53,20,33,-Inf
2005/2006,15,13,2005/2006,28,46,17,29,-Inf
2005/2006,15,14,2005/2006,29,43,4,39,-Inf
2005/2006,15,15,2005/2006,30,29,15,14,-Inf
2005/2006,15,16,2005/2006,31,22,8,14,-Inf
2005/2006,15,17,2005/2006,32,26,6,20,-Inf
2005/2006,15,18,2005/2006,33,13,12,1,-Inf
2005/2006,15,19,2005/2006,34,17,15,2,-10.819778284410283
2005/2006,15,20,2005/2006,35,8,11,3,-Inf
2005/2006,15,21,2005/2006,36,13,10,3,-11.512925464970229
2005/2006,15,22,2005/2006,37,10,15,5,-Inf
2005/2006,15,23,2005/2006,38,17,17,0,-0.37438804153769745
2005/2006,15,24,2005/2006,39,19,7,12,-11.512925464970229
2005/2006,15,25,2005/2006,40,9,7,2,-11.512925464970229
2005/2006,15,26,2005/2006,41,9,8,1,-11.512925464970229
2005/2006,15,27,2005/2006,42,9,9,0,-0.3679092415817298
2005/2006,15,28,2005/2006,43,3,12,9,-Inf
2005/2006,15,29,2005/2006,44,7,12,5,-Inf
2005/2006,15,30,2005/2006,45,7,5,2,-Inf
2005/2006,15,31,2005/2006,46,0,4,4,-11.512925464970229
2005/2006,15,32,2005/2006,47,2,11,9,-11.512925464970229
2005/2006,15,33,2005/2006,48,3,4,1,-11.512925464970229
2005/2006,15,34,2005/2006,49,3,5,2,-10.819778284410283
2005/2006,15,35,2005/2006,50,1,7,6,-Inf
2005/2006,15,36,2005/2006,51,3,1,2,-Inf
2005/2006,15,37,2005/2006,52,3,1,2,-10.819778284410283
2005/2006,15,38,2006/2007,1,3,4,1,-Inf
2005/2006,15,39,2006/2007,2,7,2,5,-Inf
2005/2006,15,40,2006/2007,3,3,6,3,-Inf
2005/2006,15,41,2006/2007,4,5,3,2,-10.41431317630212
2005/2006,15,42,2006/2007,5,11,4,7,-Inf
2005/2006,15,43,2006/2007,6,5,10,5,-Inf
2005/2006,15,44,2006/2007,7,5,12,7,-Inf
2005/2006,15,45,2006/2007,8,6,21,15,-Inf
2005/2006,15,46,2006/2007,9,6,26,20,-Inf
2005/2006,15,47,2006/2007,10,4,21,17,-Inf
2005/2006,15,48,2006/2007,11,4,30,26,-Inf
2005/2006,15,49,2006/2007,12,8,45,37,-Inf
2005/2006,15,50,2006/2007,13,14,56,42,-Inf
2005/2006,15,51,2006/2007,14,12,75,63,-Inf
2005/2006,15,52,2006/2007,15,16,83,67,-Inf
2005/2006,16,1,2005/2006,17,126,14,112,-Inf
2005/2006,16,2,2005/2006,18,119,7,112,-Inf
2005/2006,16,3,2005/2006,19,137,14,123,-Inf
2005/2006,16,4,2005/2006,20,131,10,121,-Inf
2005/2006,16,5,2005/2006,21,112,13,99,-Inf
2005/2006,16,6,2005/2006,22,82,27,55,-Inf
2005/2006,16,7,2005/2006,23,73,13,60,-Inf
2005/2006,16,8,2005/2006,24,43,18,25,-Inf
2005/2006,16,9,2005/2006,25,55,16,39,-Inf
2005/2006,16,10,2005/2006,26,55,16,39,-Inf
2005/2006,16,11,2005/2006,27,53,20,33,-Inf
2005/2006,16,12,2005/2006,28,46,17,29,-11.512925464970229
2005/2006,16,13,2005/2006,29,43,4,39,-Inf
2005/2006,16,14,2005/2006,30,29,15,14,-Inf
2005/2006,16,15,2005/2006,31,22,8,14,-Inf
2005/2006,16,16,2005/2006,32,26,6,20,-Inf
2005/2006,16,17,2005/2006,33,13,12,1,-10.41431317630212
2005/2006,16,18,2005/2006,34,17,15,2,-Inf
2005/2006,16,19,2005/2006,35,8,11,3,-Inf
2005/2006,16,20,2005/2006,36,13,10,3,-Inf
2005/2006,16,21,2005/2006,37,10,15,5,-Inf
2005/2006,16,22,2005/2006,38,17,17,0,-0.37792776511507675
2005/2006,16,23,2005/2006,39,19,7,12,-Inf
2005/2006,16,24,2005/2006,40,9,7,2,-11.512925464970229
2005/2006,16,25,2005/2006,41,9,8,1,-Inf
2005/2006,16,26,2005/2006,42,9,9,0,-0.3707738683182349
2005/2006,16,27,2005/2006,43,3,12,9,-Inf
2005/2006,16,28,2005/2006,44,7,12,5,-Inf
2005/2006,16,29,2005/2006,45,7,5,2,-Inf
2005/2006,16,30,2005/2006,46,0,4,4,-Inf
2005/2006,16,31,2005/2006,47,2,11,9,-Inf
2005/2006,16,32,2005/2006,48,3,4,1,-11.512925464970229
2005/2006,16,33,2005/2006,49,3,5,2,-Inf
2005/2006,16,34,2005/2006,50,1,7,6,-11.512925464970229
2005/2006,16,35,2005/2006,51,3,1,2,-10.819778284410283
2005/2006,16,36,2005/2006,52,3,1,2,-Inf
2005/2006,16,37,2006/2007,1,3,4,1,-11.512925464970229
2005/2006,16,38,2006/2007,2,7,2,5,-11.512925464970229
2005/2006,16,39,2006/2007,3,3,6,3,-Inf
2005/2006,16,40,2006/2007,4,5,3,2,-Inf
2005/2006,16,41,2006/2007,5,11,4,7,-Inf
2005/2006,16,42,2006/2007,6,5,10,5,-Inf
2005/2006,16,43,2006/2007,7,5,12,7,-Inf
2005/2006,16,44,2006/2007,8,6,21,15,-Inf
2005/2006,16,45,2006/2007,9,6,26,20,-Inf
2005/2006,16,46,2006/2007,10,4,21,17,-Inf
2005/2006,16,47,2006/2007,11,4,30,26,-Inf
2005/2006,16,48,2006/2007,12,8,45,37,-Inf
2005/2006,16,49,2006/2007,13,14,56,42,-Inf
2005/2006,16,50,2006/2007,14,12,75,63,-Inf
2005/2006,16,51,2006/2007,15,16,83,67,-Inf
2005/2006,16,52,2006/2007,16,10,82,72,-Inf
2005/2006,17,1,2005/2006,18,119,7,112,-Inf
2005/2006,17,2,2005/2006,19,137,14,123,-Inf
2005/2006,17,3,2005/2006,20,131,10,121,-Inf
2005/2006,17,4,2005/2006,21,112,13,99,-Inf
2005/2006,17,5,2005/2006,22,82,27,55,-Inf
2005/2006,17,6,2005/2006,23,73,13,60,-Inf
2005/2006,17,7,2005/2006,24,43,18,25,-Inf
2005/2006,17,8,2005/2006,25,55,16,39,-Inf
2005/2006,17,9,2005/2006,26,55,16,39,-Inf
2005/2006,17,10,2005/2006,27,53,20,33,-Inf
2005/2006,17,11,2005/2006,28,46,17,29,-Inf
2005/2006,17,12,2005/2006,29,43,4,39,-Inf
2005/2006,17,13,2005/2006,30,29,15,14,-Inf
2005/2006,17,14,2005/2006,31,22,8,14,-11.512925464970229
2005/2006,17,15,2005/2006,32,26,6,20,-Inf
2005/2006,17,16,2005/2006,33,13,12,1,-Inf
2005/2006,17,17,2005/2006,34,17,15,2,-11.512925464970229
2005/2006,17,18,2005/2006,35,8,11,3,-Inf
2005/2006,17,19,2005/2006,36,13,10,3,-10.819778284410283
2005/2006,17,20,2005/2006,37,10,15,5,-Inf
2005/2006,17,21,2005/2006,38,17,17,0,-0.38085054734424517
2005/2006,17,22,2005/2006,39,19,7,12,-Inf
2005/2006,17,23,2005/2006,40,9,7,2,-11.512925464970229
2005/2006,17,24,2005/2006,41,9,8,1,-11.512925464970229
2005/2006,17,25,2005/2006,42,9,9,0,-0.37041172005077705
2005/2006,17,26,2005/2006,43,3,12,9,-11.512925464970229
2005/2006,17,27,2005/2006,44,7,12,5,-Inf
2005/2006,17,28,2005/2006,45,7,5,2,-10.41431317630212
2005/2006,17,29,2005/2006,46,0,4,4,-Inf
2005/2006,17,30,2005/2006,47,2,11,9,-Inf
2005/2006,17,31,2005/2006,48,3,4,1,-11.512925464970229
2005/2006,17,32,2005/2006,49,3,5,2,-Inf
2005/2006,17,33,2005/2006,50,1,7,6,-Inf
2005/2006,17,34,2005/2006,51,3,1,2,-Inf
2005/2006,17,35,2005/2006,52,3,1,2,-11.512925464970229
2005/2006,17,36,2006/2007,1,3,4,1,-Inf
2005/2006,17,37,2006/2007,2,7,2,5,-Inf
2005/2006,17,38,2006/2007,3,3,6,3,-Inf
2005/2006,17,39,2006/2007,4,5,3,2,-Inf
2005/2006,17,40,2006/2007,5,11,4,7,-11.512925464970229
2005/2006,17,41,2006/2007,6,5,10,5,-Inf
2005/2006,17,42,2006/2007,7,5,12,7,-Inf
2005/2006,17,43,2006/2007,8,6,21,15,-Inf
2005/2006,17,44,2006/2007,9,6,26,20,-Inf
2005/2006,17,45,2006/2007,10,4,21,17,-Inf
2005/2006,17,46,2006/2007,11,4,30,26,-Inf
2005/2006,17,47,2006/2007,12,8,45,37,-Inf
2005/2006,17,48,2006/2007,13,14,56,42,-Inf
2005/2006,17,49,2006/2007,14,12,75,63,-Inf
2005/2006,17,50,2006/2007,15,16,83,67,-Inf
2005/2006,17,51,2006/2007,16,10,82,72,-Inf
2005/2006,17,52,2006/2007,17,16,126,110,-Inf
2005/2006,18,1,2005/2006,19,137,14,123,-Inf
2005/2006,18,2,2005/2006,20,131,10,121,-Inf
2005/2006,18,3,2005/2006,21,112,13,99,-Inf
2005/2006,18,4,2005/2006,22,82,27,55,-Inf
2005/2006,18,5,2005/2006,23,73,13,60,-Inf
2005/2006,18,6,2005/2006,24,43,18,25,-Inf
2005/2006,18,7,2005/2006,25,55,16,39,-Inf
2005/2006,18,8,2005/2006,26,55,16,39,-Inf
2005/2006,18,9,2005/2006,27,53,20,33,-Inf
2005/2006,18,10,2005/2006,28,46,17,29,-Inf
2005/2006,18,11,2005/2006,29,43,4,39,-Inf
2005/2006,18,12,2005/2006,30,29,15,14,-Inf
2005/2006,18,13,2005/2006,31,22,8,14,-Inf
2005/2006,18,14,2005/2006,32,26,6,20,-Inf
2005/2006,18,15,2005/2006,33,13,12,1,-Inf
2005/2006,18,16,2005/2006,34,17,15,2,-Inf
2005/2006,18,17,2005/2006,35,8,11,3,-Inf
2005/2006,18,18,2005/2006,36,13,10,3,-Inf
2005/2006,18,19,2005/2006,37,10,15,5,-Inf
2005/2006,18,20,2005/2006,38,17,17,0,-0.38335631852018714
2005/2006,18,21,2005/2006,39,19,7,12,-Inf
2005/2006,18,22,2005/2006,40,9,7,2,-11.512925464970229
2005/2006,18,23,2005/2006,41,9,8,1,-11.512925464970229
2005/2006,18,24,2005/2006,42,9,9,0,-0.3720206608888095
2005/2006,18,25,2005/2006,43,3,12,9,-Inf
2005/2006,18,26,2005/2006,44,7,12,5,-Inf
2005/2006,18,27,2005/2006,45,7,5,2,-10.819778284410283
2005/2006,18,28,2005/2006,46,0,4,4,-Inf
2005/2006,18,29,2005/2006,47,2,11,9,-Inf
2005/2006,18,30,2005/2006,48,3,4,1,-11.512925464970229
2005/2006,18,31,2005/2006,49,3,5,2,-11.512925464970229
2005/2006,18,32,2005/2006,50,1,7,6,-Inf
2005/2006,18,33,2005/2006,51,3,1,2,-Inf
2005/2006,18,34,2005/2006,52,3,1,2,-Inf
2005/2006,18,35,2006/2007,1,3,4,1,-11.512925464970229
2005/2006,18,36,2006/2007,2,7,2,5,-Inf
2005/2006,18,37,2006/2007,3,3,6,3,-Inf
2005/2006,18,38,2006/2007,4,5,3,2,-Inf
2005/2006,18,39,2006/2007,5,11,4,7,-Inf
2005/2006,18,40,2006/2007,6,5,10,5,-Inf
2005/2006,18,41,2006/2007,7,5,12,7,-Inf
2005/2006,18,42,2006/2007,8,6,21,15,-Inf
2005/2006,18,43,2006/2007,9,6,26,20,-Inf
2005/2006,18,44,2006/2007,10,4,21,17,-Inf
2005/2006,18,45,2006/2007,11,4,30,26,-Inf
2005/2006,18,46,2006/2007,12,8,45,37,-Inf
2005/2006,18,47,2006/2007,13,14,56,42,-Inf
2005/2006,18,48,2006/2007,14,12,75,63,-Inf
2005/2006,18,49,2006/2007,15,16,83,67,-Inf
2005/2006,18,50,2006/2007,16,10,82,72,-Inf
2005/2006,18,51,2006/2007,17,16,126,110,-Inf
2005/2006,18,52,2006/2007,18,18,119,101,-Inf
2005/2006,19,1,2005/2006,20,131,10,121,-11.512925464970229
2005/2006,19,2,2005/2006,21,112,13,99,-Inf
2005/2006,19,3,2005/2006,22,82,27,55,-Inf
2005/2006,19,4,2005/2006,23,73,13,60,-Inf
2005/2006,19,5,2005/2006,24,43,18,25,-Inf
2005/2006,19,6,2005/2006,25,55,16,39,-Inf
2005/2006,19,7,2005/2006,26,55,16,39,-Inf
2005/2006,19,8,2005/2006,27,53,20,33,-Inf
2005/2006,19,9,2005/2006,28,46,17,29,-Inf
2005/2006,19,10,2005/2006,29,43,4,39,-Inf
2005/2006,19,11,2005/2006,30,29,15,14,-Inf
2005/2006,19,12,2005/2006,31,22,8,14,-Inf
2005/2006,19,13,2005/2006,32,26,6,20,-Inf
2005/2006,19,14,2005/2006,33,13,12,1,-11.512925464970229
2005/2006,19,15,2005/2006,34,17,15,2,-Inf
2005/2006,19,16,2005/2006,35,8,11,3,-Inf
2005/2006,19,17,2005/2006,36,13,10,3,-11.512925464970229
2005/2006,19,18,2005/2006,37,10,15,5,-Inf
2005/2006,19,19,2005/2006,38,17,17,0,-0.38554484067303463
2005/2006,19,20,2005/2006,39,19,7,12,-Inf
2005/2006,19,21,2005/2006,40,9,7,2,-Inf
2005/2006,19,22,2005/2006,41,9,8,1,-10.819778284410283
2005/2006,19,23,2005/2006,42,9,9,0,-0.37438804153769745
2005/2006,19,24,2005/2006,43,3,12,9,-Inf
2005/2006,19,25,2005/2006,44,7,12,5,-Inf
2005/2006,19,26,2005/2006,45,7,5,2,-Inf
2005/2006,19,27,2005/2006,46,0,4,4,-Inf
2005/2006,19,28,2005/2006,47,2,11,9,-Inf
2005/2006,19,29,2005/2006,48,3,4,1,-11.512925464970229
2005/2006,19,30,2005/2006,49,3,5,2,-Inf
2005/2006,19,31,2005/2006,50,1,7,6,-Inf
2005/2006,19,32,2005/2006,51,3,1,2,-Inf
2005/2006,19,33,2005/2006,52,3,1,2,-Inf
2005/2006,19,34,2006/2007,1,3,4,1,-11.512925464970229
2005/2006,19,35,2006/2007,2,7,2,5,-Inf
2005/2006,19,36,2006/2007,3,3,6,3,-Inf
2005/2006,19,37,2006/2007,4,5,3,2,-10.126631103850338
2005/2006,19,38,2006/2007,5,11,4,7,-Inf
2005/2006,19,39,2006/2007,6,5,10,5,-Inf
2005/2006,19,40,2006/2007,7,5,12,7,-11.512925464970229
2005/2006,19,41,2006/2007,8,6,21,15,-Inf
2005/2006,19,42,2006/2007,9,6,26,20,-Inf
2005/2006,19,43,2006/2007,10,4,21,17,-Inf
2005/2006,19,44,2006/2007,11,4,30,26,-Inf
2005/2006,19,45,2006/2007,12,8,45,37,-Inf
2005/2006,19,46,2006/2007,13,14,56,42,-Inf
2005/2006,19,47,2006/2007,14,12,75,63,-Inf
2005/2006,19,48,2006/2007,15,16,83,67,-Inf
2005/2006,19,49,2006/2007,16,10,82,72,-Inf
2005/2006,19,50,2006/2007,17,16,126,110,-Inf
2005/2006,19,51,2006/2007,18,18,119,101,-Inf
2005/2006,19,52,2006/2007,19,15,137,122,-Inf
2005/2006,1,1,2005/2006,2,2,7,5,-Inf
2005/2006,1,2,2005/2006,3,6,5,1,-11.512925464970229
2005/2006,1,3,2005/2006,4,3,3,0,-0.2996062166601856
2005/2006,1,4,2005/2006,5,4,12,8,-11.512925464970229
2005/2006,1,5,2005/2006,6,10,13,3,-Inf
2005/2006,1,6,2005/2006,7,12,10,2,-Inf
2005/2006,1,7,2005/2006,8,21,13,8,-Inf
2005/2006,1,8,2005/2006,9,26,13,13,-Inf
2005/2006,1,9,2005/2006,10,21,8,13,-Inf
2005/2006,1,10,2005/2006,11,30,21,9,-Inf
2005/2006,1,11,2005/2006,12,45,18,27,-Inf
2005/2006,1,12,2005/2006,13,56,8,48,-Inf
2005/2006,1,13,2005/2006,14,75,7,68,-Inf
2005/2006,1,14,2005/2006,15,83,20,63,-Inf
2005/2006,1,15,2005/2006,16,82,14,68,-Inf
2005/2006,1,16,2005/2006,17,126,14,112,-Inf
2005/2006,1,17,2005/2006,18,119,7,112,-Inf
2005/2006,1,18,2005/2006,19,137,14,123,-Inf
2005/2006,1,19,2005/2006,20,131,10,121,-Inf
2005/2006,1,20,2005/2006,21,112,13,99,-Inf
2005/2006,1,21,2005/2006,22,82,27,55,-Inf
2005/2006,1,22,2005/2006,23,73,13,60,-Inf
2005/2006,1,23,2005/2006,24,43,18,25,-Inf
2005/2006,1,24,2005/2006,25,55,16,39,-Inf
2005/2006,1,25,2005/2006,26,55,16,39,-Inf
2005/2006,1,26,2005/2006,27,53,20,33,-Inf
2005/2006,1,27,2005/2006,28,46,17,29,-Inf
2005/2006,1,28,2005/2006,29,43,4,39,-Inf
2005/2006,1,29,2005/2006,30,29,15,14,-Inf
2005/2006,1,30,2005/2006,31,22,8,14,-Inf
2005/2006,1,31,2005/2006,32,26,6,20,-Inf
2005/2006,1,32,2005/2006,33,13,12,1,-Inf
2005/2006,1,33,2005/2006,34,17,15,2,-Inf
2005/2006,1,34,2005/2006,35,8,11,3,-Inf
2005/2006,1,35,2005/2006,36,13,10,3,-Inf
2005/2006,1,36,2005/2006,37,10,15,5,-11.512925464970229
2005/2006,1,37,2005/2006,38,17,17,0,-0.3413782514556427
2005/2006,1,38,2005/2006,39,19,7,12,-Inf
2005/2006,1,39,2005/2006,40,9,7,2,-Inf
2005/2006,1,40,2005/2006,41,9,8,1,-10.41431317630212
2005/2006,1,41,2005/2006,42,9,9,0,-0.3433216403224595
2005/2006,1,42,2005/2006,43,3,12,9,-11.512925464970229
2005/2006,1,43,2005/2006,44,7,12,5,-11.512925464970229
2005/2006,1,44,2005/2006,45,7,5,2,-10.819778284410283
2005/2006,1,45,2005/2006,46,0,4,4,-Inf
2005/2006,1,46,2005/2006,47,2,11,9,-Inf
2005/2006,1,47,2005/2006,48,3,4,1,-11.512925464970229
2005/2006,1,48,2005/2006,49,3,5,2,-Inf
2005/2006,1,49,2005/2006,50,1,7,6,-Inf
2005/2006,1,50,2005/2006,51,3,1,2,-Inf
2005/2006,1,51,2005/2006,52,3,1,2,-11.512925464970229
2005/2006,1,52,2006/2007,1,3,4,1,-11.512925464970229
2005/2006,20,1,2005/2006,21,112,13,99,-Inf
2005/2006,20,2,2005/2006,22,82,27,55,-Inf
2005/2006,20,3,2005/2006,23,73,13,60,-Inf
2005/2006,20,4,2005/2006,24,43,18,25,-Inf
2005/2006,20,5,2005/2006,25,55,16,39,-11.512925464970229
2005/2006,20,6,2005/2006,26,55,16,39,-Inf
2005/2006,20,7,2005/2006,27,53,20,33,-Inf
2005/2006,20,8,2005/2006,28,46,17,29,-Inf
2005/2006,20,9,2005/2006,29,43,4,39,-Inf
2005/2006,20,10,2005/2006,30,29,15,14,-Inf
2005/2006,20,11,2005/2006,31,22,8,14,-Inf
2005/2006,20,12,2005/2006,32,26,6,20,-Inf
2005/2006,20,13,2005/2006,33,13,12,1,-11.512925464970229
2005/2006,20,14,2005/2006,34,17,15,2,-10.819778284410283
2005/2006,20,15,2005/2006,35,8,11,3,-Inf
2005/2006,20,16,2005/2006,36,13,10,3,-11.512925464970229
2005/2006,20,17,2005/2006,37,10,15,5,-Inf
2005/2006,20,18,2005/2006,38,17,17,0,-0.38688381457181364
2005/2006,20,19,2005/2006,39,19,7,12,-Inf
2005/2006,20,20,2005/2006,40,9,7,2,-10.819778284410283
2005/2006,20,21,2005/2006,41,9,8,1,-Inf
2005/2006,20,22,2005/2006,42,9,9,0,-0.37792776511507675
2005/2006,20,23,2005/2006,43,3,12,9,-Inf
2005/2006,20,24,2005/2006,44,7,12,5,-Inf
2005/2006,20,25,2005/2006,45,7,5,2,-11.512925464970229
2005/2006,20,26,2005/2006,46,0,4,4,-Inf
2005/2006,20,27,2005/2006,47,2,11,9,-Inf
2005/2006,20,28,2005/2006,48,3,4,1,-11.512925464970229
2005/2006,20,29,2005/2006,49,3,5,2,-11.512925464970229
2005/2006,20,30,2005/2006,50,1,7,6,-Inf
2005/2006,20,31,2005/2006,51,3,1,2,-10.819778284410283
2005/2006,20,32,2005/2006,52,3,1,2,-Inf
2005/2006,20,33,2006/2007,1,3,4,1,-11.512925464970229
2005/2006,20,34,2006/2007,2,7,2,5,-Inf
2005/2006,20,35,2006/2007,3,3,6,3,-Inf
2005/2006,20,36,2006/2007,4,5,3,2,-11.512925464970229
2005/2006,20,37,2006/2007,5,11,4,7,-Inf
2005/2006,20,38,2006/2007,6,5,10,5,-Inf
2005/2006,20,39,2006/2007,7,5,12,7,-Inf
2005/2006,20,40,2006/2007,8,6,21,15,-Inf
2005/2006,20,41,2006/2007,9,6,26,20,-Inf
2005/2006,20,42,2006/2007,10,4,21,17,-Inf
2005/2006,20,43,2006/2007,11,4,30,26,-Inf
2005/2006,20,44,2006/2007,12,8,45,37,-11.512925464970229
2005/2006,20,45,2006/2007,13,14,56,42,-Inf
2005/2006,20,46,2006/2007,14,12,75,63,-Inf
2005/2006,20,47,2006/2007,15,16,83,67,-Inf
2005/2006,20,48,2006/2007,16,10,82,72,-Inf
2005/2006,20,49,2006/2007,17,16,126,110,-Inf
2005/2006,20,50,2006/2007,18,18,119,101,-Inf
2005/2006,20,51,2006/2007,19,15,137,122,-Inf
2005/2006,20,52,2006/2007,20,23,131,108,-Inf
2005/2006,21,1,2005/2006,22,82,27,55,-Inf
2005/2006,21,2,2005/2006,23,73,13,60,-Inf
2005/2006,21,3,2005/2006,24,43,18,25,-Inf
2005/2006,21,4,2005/2006,25,55,16,39,-Inf
2005/2006,21,5,2005/2006,26,55,16,39,-Inf
2005/2006,21,6,2005/2006,27,53,20,33,-Inf
2005/2006,21,7,2005/2006,28,46,17,29,-Inf
2005/2006,21,8,2005/2006,29,43,4,39,-Inf
2005/2006,21,9,2005/2006,30,29,15,14,-Inf
2005/2006,21,10,2005/2006,31,22,8,14,-Inf
2005/2006,21,11,2005/2006,32,26,6,20,-Inf
2005/2006,21,12,2005/2006,33,13,12,1,-11.512925464970229
2005/2006,21,13,2005/2006,34,17,15,2,-11.512925464970229
2005/2006,21,14,2005/2006,35,8,11,3,-Inf
2005/2006,21,15,2005/2006,36,13,10,3,-Inf
2005/2006,21,16,2005/2006,37,10,15,5,-Inf
2005/2006,21,17,2005/2006,38,17,17,0,-0.39048290393513874
2005/2006,21,18,2005/2006,39,19,7,12,-Inf
2005/2006,21,19,2005/2006,40,9,7,2,-10.126631103850338
2005/2006,21,20,2005/2006,41,9,8,1,-10.126631103850338
2005/2006,21,21,2005/2006,42,9,9,0,-0.38085054734424517
2005/2006,21,22,2005/2006,43,3,12,9,-Inf
2005/2006,21,23,2005/2006,44,7,12,5,-Inf
2005/2006,21,24,2005/2006,45,7,5,2,-11.512925464970229
2005/2006,21,25,2005/2006,46,0,4,4,-Inf
2005/2006,21,26,2005/2006,47,2,11,9,-Inf
2005/2006,21,27,2005/2006,48,3,4,1,-Inf
2005/2006,21,28,2005/2006,49,3,5,2,-Inf
2005/2006,21,29,2005/2006,50,1,7,6,-Inf
2005/2006,21,30,2005/2006,51,3,1,2,-Inf
2005/2006,21,31,2005/2006,52,3,1,2,-10.819778284410283
2005/2006,21,32,2006/2007,1,3,4,1,-Inf
2005/2006,21,33,2006/2007,2,7,2,5,-Inf
2005/2006,21,34,2006/2007,3,3,6,3,-Inf
2005/2006,21,35,2006/2007,4,5,3,2,-11.512925464970229
2005/2006,21,36,2006/2007,5,11,4,7,-Inf
2005/2006,21,37,2006/2007,6,5,10,5,-Inf
2005/2006,21,38,2006/2007,7,5,12,7,-Inf
2005/2006,21,39,2006/2007,8,6,21,15,-Inf
2005/2006,21,40,2006/2007,9,6,26,20,-Inf
2005/2006,21,41,2006/2007,10,4,21,17,-Inf
2005/2006,21,42,2006/2007,11,4,30,26,-Inf
2005/2006,21,43,2006/2007,12,8,45,37,-Inf
2005/2006,21,44,2006/2007,13,14,56,42,-Inf
2005/2006,21,45,2006/2007,14,12,75,63,-11.512925464970229
2005/2006,21,46,2006/2007,15,16,83,67,-Inf
2005/2006,21,47,2006/2007,16,10,82,72,-Inf
2005/2006,21,48,2006/2007,17,16,126,110,-Inf
2005/2006,21,49,2006/2007,18,18,119,101,-Inf
2005/2006,21,50,2006/2007,19,15,137,122,-Inf
2005/2006,21,51,2006/2007,20,23,131,108,-Inf
2005/2006,21,52,2006/2007,21,17,112,95,-Inf
2005/2006,22,1,2005/2006,23,73,13,60,-Inf
2005/2006,22,2,2005/2006,24,43,18,25,-Inf
2005/2006,22,3,2005/2006,25,55,16,39,-Inf
2005/2006,22,4,2005/2006,26,55,16,39,-Inf
2005/2006,22,5,2005/2006,27,53,20,33,-Inf
2005/2006,22,6,2005/2006,28,46,17,29,-Inf
2005/2006,22,7,2005/2006,29,43,4,39,-Inf
2005/2006,22,8,2005/2006,30,29,15,14,-Inf
2005/2006,22,9,2005/2006,31,22,8,14,-Inf
2005/2006,22,10,2005/2006,32,26,6,20,-Inf
2005/2006,22,11,2005/2006,33,13,12,1,-Inf
2005/2006,22,12,2005/2006,34,17,15,2,-Inf
2005/2006,22,13,2005/2006,35,8,11,3,-Inf
2005/2006,22,14,2005/2006,36,13,10,3,-11.512925464970229
2005/2006,22,15,2005/2006,37,10,15,5,-Inf
2005/2006,22,16,2005/2006,38,17,17,0,-0.3946735470299654
2005/2006,22,17,2005/2006,39,19,7,12,-Inf
2005/2006,22,18,2005/2006,40,9,7,2,-Inf
2005/2006,22,19,2005/2006,41,9,8,1,-10.819778284410283
2005/2006,22,20,2005/2006,42,9,9,0,-0.38335631852018714
2005/2006,22,21,2005/2006,43,3,12,9,-Inf
2005/2006,22,22,2005/2006,44,7,12,5,-Inf
2005/2006,22,23,2005/2006,45,7,5,2,-11.512925464970229
2005/2006,22,24,2005/2006,46,0,4,4,-Inf
2005/2006,22,25,2005/2006,47,2,11,9,-Inf
2005/2006,22,26,2005/2006,48,3,4,1,-10.819778284410283
2005/2006,22,27,2005/2006,49,3,5,2,-Inf
2005/2006,22,28,2005/2006,50,1,7,6,-Inf
2005/2006,22,29,2005/2006,51,3,1,2,-Inf
2005/2006,22,30,2005/2006,52,3,1,2,-Inf
2005/2006,22,31,2006/2007,1,3,4,1,-11.512925464970229
2005/2006,22,32,2006/2007,2,7,2,5,-11.512925464970229
2005/2006,22,33,2006/2007,3,3,6,3,-Inf
2005/2006,22,34,2006/2007,4,5,3,2,-Inf
2005/2006,22,35,2006/2007,5,11,4,7,-Inf
2005/2006,22,36,2006/2007,6,5,10,5,-Inf
2005/2006,22,37,2006/2007,7,5,12,7,-Inf
2005/2006,22,38,2006/2007,8,6,21,15,-Inf
2005/2006,22,39,2006/2007,9,6,26,20,-Inf
2005/2006,22,40,2006/2007,10,4,21,17,-Inf
2005/2006,22,41,2006/2007,11,4,30,26,-Inf
2005/2006,22,42,2006/2007,12,8,45,37,-Inf
2005/2006,22,43,2006/2007,13,14,56,42,-Inf
2005/2006,22,44,2006/2007,14,12,75,63,-Inf
2005/2006,22,45,2006/2007,15,16,83,67,-Inf
2005/2006,22,46,2006/2007,16,10,82,72,-Inf
2005/2006,22,47,2006/2007,17,16,126,110,-Inf
2005/2006,22,48,2006/2007,18,18,119,101,-Inf
2005/2006,22,49,2006/2007,19,15,137,122,-Inf
2005/2006,22,50,2006/2007,20,23,131,108,-Inf
2005/2006,22,51,2006/2007,21,17,112,95,-Inf
2005/2006,22,52,2006/2007,22,33,82,49,-Inf
2005/2006,23,1,2005/2006,24,43,18,25,-Inf
2005/2006,23,2,2005/2006,25,55,16,39,-Inf
2005/2006,23,3,2005/2006,26,55,16,39,-Inf
2005/2006,23,4,2005/2006,27,53,20,33,-Inf
2005/2006,23,5,2005/2006,28,46,17,29,-Inf
2005/2006,23,6,2005/2006,29,43,4,39,-Inf
2005/2006,23,7,2005/2006,30,29,15,14,-Inf
2005/2006,23,8,2005/2006,31,22,8,14,-Inf
2005/2006,23,9,2005/2006,32,26,6,20,-Inf
2005/2006,23,10,2005/2006,33,13,12,1,-10.41431317630212
2005/2006,23,11,2005/2006,34,17,15,2,-10.126631103850338
2005/2006,23,12,2005/2006,35,8,11,3,-Inf
2005/2006,23,13,2005/2006,36,13,10,3,-Inf
2005/2006,23,14,2005/2006,37,10,15,5,-Inf
2005/2006,23,15,2005/2006,38,17,17,0,-0.4028086396469561
2005/2006,23,16,2005/2006,39,19,7,12,-11.512925464970229
2005/2006,23,17,2005/2006,40,9,7,2,-11.512925464970229
2005/2006,23,18,2005/2006,41,9,8,1,-Inf
2005/2006,23,19,2005/2006,42,9,9,0,-0.38554484067303463
2005/2006,23,20,2005/2006,43,3,12,9,-Inf
2005/2006,23,21,2005/2006,44,7,12,5,-Inf
2005/2006,23,22,2005/2006,45,7,5,2,-11.512925464970229
2005/2006,23,23,2005/2006,46,0,4,4,-Inf
2005/2006,23,24,2005/2006,47,2,11,9,-Inf
2005/2006,23,25,2005/2006,48,3,4,1,-Inf
2005/2006,23,26,2005/2006,49,3,5,2,-Inf
2005/2006,23,27,2005/2006,50,1,7,6,-Inf
2005/2006,23,28,2005/2006,51,3,1,2,-10.41431317630212
2005/2006,23,29,2005/2006,52,3,1,2,-Inf
2005/2006,23,30,2006/2007,1,3,4,1,-11.512925464970229
2005/2006,23,31,2006/2007,2,7,2,5,-Inf
2005/2006,23,32,2006/2007,3,3,6,3,-Inf
2005/2006,23,33,2006/2007,4,5,3,2,-Inf
2005/2006,23,34,2006/2007,5,11,4,7,-Inf
2005/2006,23,35,2006/2007,6,5,10,5,-Inf
2005/2006,23,36,2006/2007,7,5,12,7,-Inf
2005/2006,23,37,2006/2007,8,6,21,15,-Inf
2005/2006,23,38,2006/2007,9,6,26,20,-Inf
2005/2006,23,39,2006/2007,10,4,21,17,-Inf
2005/2006,23,40,2006/2007,11,4,30,26,-Inf
2005/2006,23,41,2006/2007,12,8,45,37,-Inf
2005/2006,23,42,2006/2007,13,14,56,42,-Inf
2005/2006,23,43,2006/2007,14,12,75,63,-Inf
2005/2006,23,44,2006/2007,15,16,83,67,-Inf
2005/2006,23,45,2006/2007,16,10,82,72,-Inf
2005/2006,23,46,2006/2007,17,16,126,110,-Inf
2005/2006,23,47,2006/2007,18,18,119,101,-Inf
2005/2006,23,48,2006/2007,19,15,137,122,-Inf
2005/2006,23,49,2006/2007,20,23,131,108,-Inf
2005/2006,23,50,2006/2007,21,17,112,95,-Inf
2005/2006,23,51,2006/2007,22,33,82,49,-Inf
2005/2006,23,52,2006/2007,23,15,73,58,-Inf
2005/2006,24,1,2005/2006,25,55,16,39,-11.512925464970229
2005/2006,24,2,2005/2006,26,55,16,39,-Inf
2005/2006,24,3,2005/2006,27,53,20,33,-Inf
2005/2006,24,4,2005/2006,28,46,17,29,-Inf
2005/2006,24,5,2005/2006,29,43,4,39,-Inf
2005/2006,24,6,2005/2006,30,29,15,14,-Inf
2005/2006,24,7,2005/2006,31,22,8,14,-Inf
2005/2006,24,8,2005/2006,32,26,6,20,-Inf
2005/2006,24,9,2005/2006,33,13,12,1,-10.819778284410283
2005/2006,24,10,2005/2006,34,17,15,2,-Inf
2005/2006,24,11,2005/2006,35,8,11,3,-Inf
2005/2006,24,12,2005/2006,36,13,10,3,-10.819778284410283
2005/2006,24,13,2005/2006,37,10,15,5,-Inf
2005/2006,24,14,2005/2006,38,17,17,0,-0.40893110775133934
2005/2006,24,15,2005/2006,39,19,7,12,-Inf
2005/2006,24,16,2005/2006,40,9,7,2,-10.819778284410283
2005/2006,24,17,2005/2006,41,9,8,1,-10.41431317630212
2005/2006,24,18,2005/2006,42,9,9,0,-0.38688381457181364
2005/2006,24,19,2005/2006,43,3,12,9,-Inf
2005/2006,24,20,2005/2006,44,7,12,5,-Inf
2005/2006,24,21,2005/2006,45,7,5,2,-11.512925464970229
2005/2006,24,22,2005/2006,46,0,4,4,-Inf
2005/2006,24,23,2005/2006,47,2,11,9,-Inf
2005/2006,24,24,2005/2006,48,3,4,1,-10.819778284410283
2005/2006,24,25,2005/2006,49,3,5,2,-11.512925464970229
2005/2006,24,26,2005/2006,50,1,7,6,-Inf
2005/2006,24,27,2005/2006,51,3,1,2,-11.512925464970229
2005/2006,24,28,2005/2006,52,3,1,2,-10.41431317630212
2005/2006,24,29,2006/2007,1,3,4,1,-Inf
2005/2006,24,30,2006/2007,2,7,2,5,-11.512925464970229
2005/2006,24,31,2006/2007,3,3,6,3,-11.512925464970229
2005/2006,24,32,2006/2007,4,5,3,2,-10.819778284410283
2005/2006,24,33,2006/2007,5,11,4,7,-Inf
2005/2006,24,34,2006/2007,6,5,10,5,-Inf
2005/2006,24,35,2006/2007,7,5,12,7,-Inf
2005/2006,24,36,2006/2007,8,6,21,15,-Inf
2005/2006,24,37,2006/2007,9,6,26,20,-Inf
2005/2006,24,38,2006/2007,10,4,21,17,-Inf
2005/2006,24,39,2006/2007,11,4,30,26,-Inf
2005/2006,24,40,2006/2007,12,8,45,37,-Inf
2005/2006,24,41,2006/2007,13,14,56,42,-Inf
2005/2006,24,42,2006/2007,14,12,75,63,-Inf
2005/2006,24,43,2006/2007,15,16,83,67,-Inf
2005/2006,24,44,2006/2007,16,10,82,72,-Inf
2005/2006,24,45,2006/2007,17,16,126,110,-Inf
2005/2006,24,46,2006/2007,18,18,119,101,-Inf
2005/2006,24,47,2006/2007,19,15,137,122,-Inf
2005/2006,24,48,2006/2007,20,23,131,108,-Inf
2005/2006,24,49,2006/2007,21,17,112,95,-Inf
2005/2006,24,50,2006/2007,22,33,82,49,-Inf
2005/2006,24,51,2006/2007,23,15,73,58,-Inf
2005/2006,24,52,2006/2007,24,13,43,30,-Inf
2005/2006,25,1,2005/2006,26,55,16,39,-Inf
2005/2006,25,2,2005/2006,27,53,20,33,-11.512925464970229
2005/2006,25,3,2005/2006,28,46,17,29,-Inf
2005/2006,25,4,2005/2006,29,43,4,39,-Inf
2005/2006,25,5,2005/2006,30,29,15,14,-11.512925464970229
2005/2006,25,6,2005/2006,31,22,8,14,-Inf
2005/2006,25,7,2005/2006,32,26,6,20,-11.512925464970229
2005/2006,25,8,2005/2006,33,13,12,1,-10.819778284410283
2005/2006,25,9,2005/2006,34,17,15,2,-10.819778284410283
2005/2006,25,10,2005/2006,35,8,11,3,-Inf
2005/2006,25,11,2005/2006,36,13,10,3,-10.819778284410283
2005/2006,25,12,2005/2006,37,10,15,5,-Inf
2005/2006,25,13,2005/2006,38,17,17,0,-0.4122480604049965
2005/2006,25,14,2005/2006,39,19,7,12,-Inf
2005/2006,25,15,2005/2006,40,9,7,2,-11.512925464970229
2005/2006,25,16,2005/2006,41,9,8,1,-Inf
2005/2006,25,17,2005/2006,42,9,9,0,-0.3904533504877268
2005/2006,25,18,2005/2006,43,3,12,9,-Inf
2005/2006,25,19,2005/2006,44,7,12,5,-11.512925464970229
2005/2006,25,20,2005/2006,45,7,5,2,-11.512925464970229
2005/2006,25,21,2005/2006,46,0,4,4,-Inf
2005/2006,25,22,2005/2006,47,2,11,9,-Inf
2005/2006,25,23,2005/2006,48,3,4,1,-Inf
2005/2006,25,24,2005/2006,49,3,5,2,-11.512925464970229
2005/2006,25,25,2005/2006,50,1,7,6,-Inf
2005/2006,25,26,2005/2006,51,3,1,2,-Inf
2005/2006,25,27,2005/2006,52,3,1,2,-11.512925464970229
2005/2006,25,28,2006/2007,1,3,4,1,-11.512925464970229
2005/2006,25,29,2006/2007,2,7,2,5,-Inf
2005/2006,25,30,2006/2007,3,3,6,3,-Inf
2005/2006,25,31,2006/2007,4,5,3,2,-11.512925464970229
2005/2006,25,32,2006/2007,5,11,4,7,-Inf
2005/2006,25,33,2006/2007,6,5,10,5,-Inf
2005/2006,25,34,2006/2007,7,5,12,7,-Inf
2005/2006,25,35,2006/2007,8,6,21,15,-Inf
2005/2006,25,36,2006/2007,9,6,26,20,-Inf
2005/2006,25,37,2006/2007,10,4,21,17,-Inf
2005/2006,25,38,2006/2007,11,4,30,26,-Inf
2005/2006,25,39,2006/2007,12,8,45,37,-Inf
2005/2006,25,40,2006/2007,13,14,56,42,-Inf
2005/2006,25,41,2006/2007,14,12,75,63,-Inf
2005/2006,25,42,2006/2007,15,16,83,67,-Inf
2005/2006,25,43,2006/2007,16,10,82,72,-Inf
2005/2006,25,44,2006/2007,17,16,126,110,-Inf
2005/2006,25,45,2006/2007,18,18,119,101,-Inf
2005/2006,25,46,2006/2007,19,15,137,122,-Inf
2005/2006,25,47,2006/2007,20,23,131,108,-Inf
2005/2006,25,48,2006/2007,21,17,112,95,-Inf
2005/2006,25,49,2006/2007,22,33,82,49,-Inf
2005/2006,25,50,2006/2007,23,15,73,58,-Inf
2005/2006,25,51,2006/2007,24,13,43,30,-Inf
2005/2006,25,52,2006/2007,25,11,55,44,-Inf
2005/2006,26,1,2005/2006,27,53,20,33,-Inf
2005/2006,26,2,2005/2006,28,46,17,29,-11.512925464970229
2005/2006,26,3,2005/2006,29,43,4,39,-Inf
2005/2006,26,4,2005/2006,30,29,15,14,-Inf
2005/2006,26,5,2005/2006,31,22,8,14,-Inf
2005/2006,26,6,2005/2006,32,26,6,20,-11.512925464970229
2005/2006,26,7,2005/2006,33,13,12,1,-10.126631103850338
2005/2006,26,8,2005/2006,34,17,15,2,-10.41431317630212
2005/2006,26,9,2005/2006,35,8,11,3,-Inf
2005/2006,26,10,2005/2006,36,13,10,3,-Inf
2005/2006,26,11,2005/2006,37,10,15,5,-Inf
2005/2006,26,12,2005/2006,38,17,17,0,-0.419310514930217
2005/2006,26,13,2005/2006,39,19,7,12,-Inf
2005/2006,26,14,2005/2006,40,9,7,2,-10.41431317630212
2005/2006,26,15,2005/2006,41,9,8,1,-Inf
2005/2006,26,16,2005/2006,42,9,9,0,-0.3946735470299654
2005/2006,26,17,2005/2006,43,3,12,9,-Inf
2005/2006,26,18,2005/2006,44,7,12,5,-Inf
2005/2006,26,19,2005/2006,45,7,5,2,-10.819778284410283
2005/2006,26,20,2005/2006,46,0,4,4,-Inf
2005/2006,26,21,2005/2006,47,2,11,9,-Inf
2005/2006,26,22,2005/2006,48,3,4,1,-Inf
2005/2006,26,23,2005/2006,49,3,5,2,-Inf
2005/2006,26,24,2005/2006,50,1,7,6,-Inf
2005/2006,26,25,2005/2006,51,3,1,2,-Inf
2005/2006,26,26,2005/2006,52,3,1,2,-Inf
2005/2006,26,27,2006/2007,1,3,4,1,-Inf
2005/2006,26,28,2006/2007,2,7,2,5,-Inf
2005/2006,26,29,2006/2007,3,3,6,3,-11.512925464970229
2005/2006,26,30,2006/2007,4,5,3,2,-11.512925464970229
2005/2006,26,31,2006/2007,5,11,4,7,-Inf
2005/2006,26,32,2006/2007,6,5,10,5,-Inf
2005/2006,26,33,2006/2007,7,5,12,7,-Inf
2005/2006,26,34,2006/2007,8,6,21,15,-Inf
2005/2006,26,35,2006/2007,9,6,26,20,-Inf
2005/2006,26,36,2006/2007,10,4,21,17,-Inf
2005/2006,26,37,2006/2007,11,4,30,26,-Inf
2005/2006,26,38,2006/2007,12,8,45,37,-Inf
2005/2006,26,39,2006/2007,13,14,56,42,-Inf
2005/2006,26,40,2006/2007,14,12,75,63,-Inf
2005/2006,26,41,2006/2007,15,16,83,67,-Inf
2005/2006,26,42,2006/2007,16,10,82,72,-Inf
2005/2006,26,43,2006/2007,17,16,126,110,-Inf
2005/2006,26,44,2006/2007,18,18,119,101,-Inf
2005/2006,26,45,2006/2007,19,15,137,122,-Inf
2005/2006,26,46,2006/2007,20,23,131,108,-Inf
2005/2006,26,47,2006/2007,21,17,112,95,-Inf
2005/2006,26,48,2006/2007,22,33,82,49,-Inf
2005/2006,26,49,2006/2007,23,15,73,58,-Inf
2005/2006,26,50,2006/2007,24,13,43,30,-Inf
2005/2006,26,51,2006/2007,25,11,55,44,-Inf
2005/2006,26,52,2006/2007,26,14,55,41,-Inf
2005/2006,27,1,2005/2006,28,46,17,29,-11.512925464970229
2005/2006,27,2,2005/2006,29,43,4,39,-11.512925464970229
2005/2006,27,3,2005/2006,30,29,15,14,-Inf
2005/2006,27,4,2005/2006,31,22,8,14,-Inf
2005/2006,27,5,2005/2006,32,26,6,20,-Inf
2005/2006,27,6,2005/2006,33,13,12,1,-11.512925464970229
2005/2006,27,7,2005/2006,34,17,15,2,-Inf
2005/2006,27,8,2005/2006,35,8,11,3,-Inf
2005/2006,27,9,2005/2006,36,13,10,3,-Inf
2005/2006,27,10,2005/2006,37,10,15,5,-Inf
2005/2006,27,11,2005/2006,38,17,17,0,-0.42873885276788215
2005/2006,27,12,2005/2006,39,19,7,12,-Inf
2005/2006,27,13,2005/2006,40,9,7,2,-Inf
2005/2006,27,14,2005/2006,41,9,8,1,-10.819778284410283
2005/2006,27,15,2005/2006,42,9,9,0,-0.4028086396469561
2005/2006,27,16,2005/2006,43,3,12,9,-Inf
2005/2006,27,17,2005/2006,44,7,12,5,-Inf
2005/2006,27,18,2005/2006,45,7,5,2,-Inf
2005/2006,27,19,2005/2006,46,0,4,4,-Inf
2005/2006,27,20,2005/2006,47,2,11,9,-Inf
2005/2006,27,21,2005/2006,48,3,4,1,-11.512925464970229
2005/2006,27,22,2005/2006,49,3,5,2,-Inf
2005/2006,27,23,2005/2006,50,1,7,6,-Inf
2005/2006,27,24,2005/2006,51,3,1,2,-Inf
2005/2006,27,25,2005/2006,52,3,1,2,-Inf
2005/2006,27,26,2006/2007,1,3,4,1,-10.819778284410283
2005/2006,27,27,2006/2007,2,7,2,5,-11.512925464970229
2005/2006,27,28,2006/2007,3,3,6,3,-Inf
2005/2006,27,29,2006/2007,4,5,3,2,-11.512925464970229
2005/2006,27,30,2006/2007,5,11,4,7,-Inf
2005/2006,27,31,2006/2007,6,5,10,5,-Inf
2005/2006,27,32,2006/2007,7,5,12,7,-Inf
2005/2006,27,33,2006/2007,8,6,21,15,-Inf
2005/2006,27,34,2006/2007,9,6,26,20,-Inf
2005/2006,27,35,2006/2007,10,4,21,17,-Inf
2005/2006,27,36,2006/2007,11,4,30,26,-Inf
2005/2006,27,37,2006/2007,12,8,45,37,-Inf
2005/2006,27,38,2006/2007,13,14,56,42,-Inf
2005/2006,27,39,2006/2007,14,12,75,63,-Inf
2005/2006,27,40,2006/2007,15,16,83,67,-Inf
2005/2006,27,41,2006/2007,16,10,82,72,-Inf
2005/2006,27,42,2006/2007,17,16,126,110,-Inf
2005/2006,27,43,2006/2007,18,18,119,101,-Inf
2005/2006,27,44,2006/2007,19,15,137,122,-Inf
2005/2006,27,45,2006/2007,20,23,131,108,-Inf
2005/2006,27,46,2006/2007,21,17,112,95,-Inf
2005/2006,27,47,2006/2007,22,33,82,49,-Inf
2005/2006,27,48,2006/2007,23,15,73,58,-Inf
2005/2006,27,49,2006/2007,24,13,43,30,-Inf
2005/2006,27,50,2006/2007,25,11,55,44,-Inf
2005/2006,27,51,2006/2007,26,14,55,41,-Inf
2005/2006,27,52,2006/2007,27,17,53,36,-Inf
2005/2006,28,1,2005/2006,29,43,4,39,-Inf
2005/2006,28,2,2005/2006,30,29,15,14,-Inf
2005/2006,28,3,2005/2006,31,22,8,14,-11.512925464970229
2005/2006,28,4,2005/2006,32,26,6,20,-Inf
2005/2006,28,5,2005/2006,33,13,12,1,-9.721165995742174
2005/2006,28,6,2005/2006,34,17,15,2,-11.512925464970229
2005/2006,28,7,2005/2006,35,8,11,3,-Inf
2005/2006,28,8,2005/2006,36,13,10,3,-Inf
2005/2006,28,9,2005/2006,37,10,15,5,-Inf
2005/2006,28,10,2005/2006,38,17,17,0,-0.4328311661713542
2005/2006,28,11,2005/2006,39,19,7,12,-11.512925464970229
2005/2006,28,12,2005/2006,40,9,7,2,-10.41431317630212
2005/2006,28,13,2005/2006,41,9,8,1,-11.512925464970229
2005/2006,28,14,2005/2006,42,9,9,0,-0.40893110775133934
2005/2006,28,15,2005/2006,43,3,12,9,-Inf
2005/2006,28,16,2005/2006,44,7,12,5,-Inf
2005/2006,28,17,2005/2006,45,7,5,2,-10.819778284410283
2005/2006,28,18,2005/2006,46,0,4,4,-Inf
2005/2006,28,19,2005/2006,47,2,11,9,-Inf
2005/2006,28,20,2005/2006,48,3,4,1,-11.512925464970229
2005/2006,28,21,2005/2006,49,3,5,2,-10.819778284410283
2005/2006,28,22,2005/2006,50,1,7,6,-Inf
2005/2006,28,23,2005/2006,51,3,1,2,-Inf
2005/2006,28,24,2005/2006,52,3,1,2,-Inf
2005/2006,28,25,2006/2007,1,3,4,1,-Inf
2005/2006,28,26,2006/2007,2,7,2,5,-Inf
2005/2006,28,27,2006/2007,3,3,6,3,-Inf
2005/2006,28,28,2006/2007,4,5,3,2,-11.512925464970229
2005/2006,28,29,2006/2007,5,11,4,7,-Inf
2005/2006,28,30,2006/2007,6,5,10,5,-Inf
2005/2006,28,31,2006/2007,7,5,12,7,-Inf
2005/2006,28,32,2006/2007,8,6,21,15,-Inf
2005/2006,28,33,2006/2007,9,6,26,20,-Inf
2005/2006,28,34,2006/2007,10,4,21,17,-Inf
2005/2006,28,35,2006/2007,11,4,30,26,-Inf
2005/2006,28,36,2006/2007,12,8,45,37,-Inf
2005/2006,28,37,2006/2007,13,14,56,42,-Inf
2005/2006,28,38,2006/2007,14,12,75,63,-Inf
2005/2006,28,39,2006/2007,15,16,83,67,-Inf
2005/2006,28,40,2006/2007,16,10,82,72,-Inf
2005/2006,28,41,2006/2007,17,16,126,110,-Inf
2005/2006,28,42,2006/2007,18,18,119,101,-Inf
2005/2006,28,43,2006/2007,19,15,137,122,-Inf
2005/2006,28,44,2006/2007,20,23,131,108,-Inf
2005/2006,28,45,2006/2007,21,17,112,95,-Inf
2005/2006,28,46,2006/2007,22,33,82,49,-Inf
2005/2006,28,47,2006/2007,23,15,73,58,-Inf
2005/2006,28,48,2006/2007,24,13,43,30,-Inf
2005/2006,28,49,2006/2007,25,11,55,44,-Inf
2005/2006,28,50,2006/2007,26,14,55,41,-Inf
2005/2006,28,51,2006/2007,27,17,53,36,-Inf
2005/2006,28,52,2006/2007,28,19,46,27,-Inf
2005/2006,29,1,2005/2006,30,29,15,14,-Inf
2005/2006,29,2,2005/2006,31,22,8,14,-Inf
2005/2006,29,3,2005/2006,32,26,6,20,-11.512925464970229
2005/2006,29,4,2005/2006,33,13,12,1,-10.819778284410283
2005/2006,29,5,2005/2006,34,17,15,2,-Inf
2005/2006,29,6,2005/2006,35,8,11,3,-Inf
2005/2006,29,7,2005/2006,36,13,10,3,-11.512925464970229
2005/2006,29,8,2005/2006,37,10,15,5,-Inf
2005/2006,29,9,2005/2006,38,17,17,0,-0.4430890967048544
2005/2006,29,10,2005/2006,39,19,7,12,-Inf
2005/2006,29,11,2005/2006,40,9,7,2,-10.819778284410283
2005/2006,29,12,2005/2006,41,9,8,1,-11.512925464970229
2005/2006,29,13,2005/2006,42,9,9,0,-0.4122480604049965
2005/2006,29,14,2005/2006,43,3,12,9,-Inf
2005/2006,29,15,2005/2006,44,7,12,5,-11.512925464970229
2005/2006,29,16,2005/2006,45,7,5,2,-10.41431317630212
2005/2006,29,17,2005/2006,46,0,4,4,-Inf
2005/2006,29,18,2005/2006,47,2,11,9,-Inf
2005/2006,29,19,2005/2006,48,3,4,1,-11.512925464970229
2005/2006,29,20,2005/2006,49,3,5,2,-Inf
2005/2006,29,21,2005/2006,50,1,7,6,-Inf
2005/2006,29,22,2005/2006,51,3,1,2,-Inf
2005/2006,29,23,2005/2006,52,3,1,2,-Inf
2005/2006,29,24,2006/2007,1,3,4,1,-11.512925464970229
2005/2006,29,25,2006/2007,2,7,2,5,-Inf
2005/2006,29,26,2006/2007,3,3,6,3,-Inf
2005/2006,29,27,2006/2007,4,5,3,2,-11.512925464970229
2005/2006,29,28,2006/2007,5,11,4,7,-Inf
2005/2006,29,29,2006/2007,6,5,10,5,-Inf
2005/2006,29,30,2006/2007,7,5,12,7,-Inf
2005/2006,29,31,2006/2007,8,6,21,15,-Inf
2005/2006,29,32,2006/2007,9,6,26,20,-Inf
2005/2006,29,33,2006/2007,10,4,21,17,-Inf
2005/2006,29,34,2006/2007,11,4,30,26,-Inf
2005/2006,29,35,2006/2007,12,8,45,37,-Inf
2005/2006,29,36,2006/2007,13,14,56,42,-Inf
2005/2006,29,37,2006/2007,14,12,75,63,-Inf
2005/2006,29,38,2006/2007,15,16,83,67,-Inf
2005/2006,29,39,2006/2007,16,10,82,72,-Inf
2005/2006,29,40,2006/2007,17,16,126,110,-Inf
2005/2006,29,41,2006/2007,18,18,119,101,-Inf
2005/2006,29,42,2006/2007,19,15,137,122,-Inf
2005/2006,29,43,2006/2007,20,23,131,108,-Inf
2005/2006,29,44,2006/2007,21,17,112,95,-Inf
2005/2006,29,45,2006/2007,22,33,82,49,-Inf
2005/2006,29,46,2006/2007,23,15,73,58,-Inf
2005/2006,29,47,2006/2007,24,13,43,30,-Inf
2005/2006,29,48,2006/2007,25,11,55,44,-Inf
2005/2006,29,49,2006/2007,26,14,55,41,-Inf
2005/2006,29,50,2006/2007,27,17,53,36,-Inf
2005/2006,29,51,2006/2007,28,19,46,27,-Inf
2005/2006,29,52,2006/2007,29,20,43,23,-Inf
2005/2006,2,1,2005/2006,3,6,5,1,-Inf
2005/2006,2,2,2005/2006,4,3,3,0,-0.43062908177171444
2005/2006,2,3,2005/2006,5,4,12,8,-Inf
2005/2006,2,4,2005/2006,6,10,13,3,-11.512925464970229
2005/2006,2,5,2005/2006,7,12,10,2,-Inf
2005/2006,2,6,2005/2006,8,21,13,8,-Inf
2005/2006,2,7,2005/2006,9,26,13,13,-Inf
2005/2006,2,8,2005/2006,10,21,8,13,-Inf
2005/2006,2,9,2005/2006,11,30,21,9,-Inf
2005/2006,2,10,2005/2006,12,45,18,27,-Inf
2005/2006,2,11,2005/2006,13,56,8,48,-Inf
2005/2006,2,12,2005/2006,14,75,7,68,-Inf
2005/2006,2,13,2005/2006,15,83,20,63,-Inf
2005/2006,2,14,2005/2006,16,82,14,68,-Inf
2005/2006,2,15,2005/2006,17,126,14,112,-Inf
2005/2006,2,16,2005/2006,18,119,7,112,-Inf
2005/2006,2,17,2005/2006,19,137,14,123,-Inf
2005/2006,2,18,2005/2006,20,131,10,121,-Inf
2005/2006,2,19,2005/2006,21,112,13,99,-Inf
2005/2006,2,20,2005/2006,22,82,27,55,-Inf
2005/2006,2,21,2005/2006,23,73,13,60,-Inf
2005/2006,2,22,2005/2006,24,43,18,25,-Inf
2005/2006,2,23,2005/2006,25,55,16,39,-Inf
2005/2006,2,24,2005/2006,26,55,16,39,-Inf
2005/2006,2,25,2005/2006,27,53,20,33,-Inf
2005/2006,2,26,2005/2006,28,46,17,29,-Inf
2005/2006,2,27,2005/2006,29,43,4,39,-Inf
2005/2006,2,28,2005/2006,30,29,15,14,-Inf
2005/2006,2,29,2005/2006,31,22,8,14,-Inf
2005/2006,2,30,2005/2006,32,26,6,20,-Inf
2005/2006,2,31,2005/2006,33,13,12,1,-11.512925464970229
2005/2006,2,32,2005/2006,34,17,15,2,-Inf
2005/2006,2,33,2005/2006,35,8,11,3,-Inf
2005/2006,2,34,2005/2006,36,13,10,3,-11.512925464970229
2005/2006,2,35,2005/2006,37,10,15,5,-11.512925464970229
2005/2006,2,36,2005/2006,38,17,17,0,-0.35217081705044784
2005/2006,2,37,2005/2006,39,19,7,12,-Inf
2005/2006,2,38,2005/2006,40,9,7,2,-Inf
2005/2006,2,39,2005/2006,41,9,8,1,-10.819778284410283
2005/2006,2,40,2005/2006,42,9,9,0,-0.3475170061539661
2005/2006,2,41,2005/2006,43,3,12,9,-Inf
2005/2006,2,42,2005/2006,44,7,12,5,-Inf
2005/2006,2,43,2005/2006,45,7,5,2,-Inf
2005/2006,2,44,2005/2006,46,0,4,4,-Inf
2005/2006,2,45,2005/2006,47,2,11,9,-Inf
2005/2006,2,46,2005/2006,48,3,4,1,-10.819778284410283
2005/2006,2,47,2005/2006,49,3,5,2,-Inf
2005/2006,2,48,2005/2006,50,1,7,6,-Inf
2005/2006,2,49,2005/2006,51,3,1,2,-10.819778284410283
2005/2006,2,50,2005/2006,52,3,1,2,-Inf
2005/2006,2,51,2006/2007,1,3,4,1,-10.819778284410283
2005/2006,2,52,2006/2007,2,7,2,5,-Inf
2005/2006,30,1,2005/2006,31,22,8,14,-Inf
2005/2006,30,2,2005/2006,32,26,6,20,-11.512925464970229
2005/2006,30,3,2005/2006,33,13,12,1,-11.512925464970229
2005/2006,30,4,2005/2006,34,17,15,2,-11.512925464970229
2005/2006,30,5,2005/2006,35,8,11,3,-Inf
2005/2006,30,6,2005/2006,36,13,10,3,-11.512925464970229
2005/2006,30,7,2005/2006,37,10,15,5,-11.512925464970229
2005/2006,30,8,2005/2006,38,17,17,0,-0.45359499031171957
2005/2006,30,9,2005/2006,39,19,7,12,-11.512925464970229
2005/2006,30,10,2005/2006,40,9,7,2,-11.512925464970229
2005/2006,30,11,2005/2006,41,9,8,1,-10.126631103850338
2005/2006,30,12,2005/2006,42,9,9,0,-0.419310514930217
2005/2006,30,13,2005/2006,43,3,12,9,-Inf
2005/2006,30,14,2005/2006,44,7,12,5,-Inf
2005/2006,30,15,2005/2006,45,7,5,2,-11.512925464970229
2005/2006,30,16,2005/2006,46,0,4,4,-Inf
2005/2006,30,17,2005/2006,47,2,11,9,-Inf
2005/2006,30,18,2005/2006,48,3,4,1,-Inf
2005/2006,30,19,2005/2006,49,3,5,2,-11.512925464970229
2005/2006,30,20,2005/2006,50,1,7,6,-11.512925464970229
2005/2006,30,21,2005/2006,51,3,1,2,-10.819778284410283
2005/2006,30,22,2005/2006,52,3,1,2,-Inf
2005/2006,30,23,2006/2007,1,3,4,1,-11.512925464970229
2005/2006,30,24,2006/2007,2,7,2,5,-Inf
2005/2006,30,25,2006/2007,3,3,6,3,-11.512925464970229
2005/2006,30,26,2006/2007,4,5,3,2,-Inf
2005/2006,30,27,2006/2007,5,11,4,7,-Inf
2005/2006,30,28,2006/2007,6,5,10,5,-Inf
2005/2006,30,29,2006/2007,7,5,12,7,-Inf
2005/2006,30,30,2006/2007,8,6,21,15,-Inf
2005/2006,30,31,2006/2007,9,6,26,20,-Inf
2005/2006,30,32,2006/2007,10,4,21,17,-Inf
2005/2006,30,33,2006/2007,11,4,30,26,-Inf
2005/2006,30,34,2006/2007,12,8,45,37,-Inf
2005/2006,30,35,2006/2007,13,14,56,42,-Inf
2005/2006,30,36,2006/2007,14,12,75,63,-Inf
2005/2006,30,37,2006/2007,15,16,83,67,-Inf
2005/2006,30,38,2006/2007,16,10,82,72,-Inf
2005/2006,30,39,2006/2007,17,16,126,110,-Inf
2005/2006,30,40,2006/2007,18,18,119,101,-Inf
2005/2006,30,41,2006/2007,19,15,137,122,-Inf
2005/2006,30,42,2006/2007,20,23,131,108,-Inf
2005/2006,30,43,2006/2007,21,17,112,95,-Inf
2005/2006,30,44,2006/2007,22,33,82,49,-Inf
2005/2006,30,45,2006/2007,23,15,73,58,-Inf
2005/2006,30,46,2006/2007,24,13,43,30,-Inf
2005/2006,30,47,2006/2007,25,11,55,44,-Inf
2005/2006,30,48,2006/2007,26,14,55,41,-Inf
2005/2006,30,49,2006/2007,27,17,53,36,-Inf
2005/2006,30,50,2006/2007,28,19,46,27,-Inf
2005/2006,30,51,2006/2007,29,20,43,23,-11.512925464970229
2005/2006,30,52,2006/2007,30,12,29,17,-Inf
2005/2006,31,1,2005/2006,32,26,6,20,-Inf
2005/2006,31,2,2005/2006,33,13,12,1,-11.512925464970229
2005/2006,31,3,2005/2006,34,17,15,2,-10.819778284410283
2005/2006,31,4,2005/2006,35,8,11,3,-Inf
2005/2006,31,5,2005/2006,36,13,10,3,-11.512925464970229
2005/2006,31,6,2005/2006,37,10,15,5,-Inf
2005/2006,31,7,2005/2006,38,17,17,0,-0.46754265991637567
2005/2006,31,8,2005/2006,39,19,7,12,-Inf
2005/2006,31,9,2005/2006,40,9,7,2,-11.512925464970229
2005/2006,31,10,2005/2006,41,9,8,1,-11.512925464970229
2005/2006,31,11,2005/2006,42,9,9,0,-0.42873885276788215
2005/2006,31,12,2005/2006,43,3,12,9,-Inf
2005/2006,31,13,2005/2006,44,7,12,5,-Inf
2005/2006,31,14,2005/2006,45,7,5,2,-10.126631103850338
2005/2006,31,15,2005/2006,46,0,4,4,-Inf
2005/2006,31,16,2005/2006,47,2,11,9,-Inf
2005/2006,31,17,2005/2006,48,3,4,1,-Inf
2005/2006,31,18,2005/2006,49,3,5,2,-Inf
2005/2006,31,19,2005/2006,50,1,7,6,-Inf
2005/2006,31,20,2005/2006,51,3,1,2,-Inf
2005/2006,31,21,2005/2006,52,3,1,2,-11.512925464970229
2005/2006,31,22,2006/2007,1,3,4,1,-Inf
2005/2006,31,23,2006/2007,2,7,2,5,-Inf
2005/2006,31,24,2006/2007,3,3,6,3,-Inf
2005/2006,31,25,2006/2007,4,5,3,2,-Inf
2005/2006,31,26,2006/2007,5,11,4,7,-Inf
2005/2006,31,27,2006/2007,6,5,10,5,-11.512925464970229
2005/2006,31,28,2006/2007,7,5,12,7,-Inf
2005/2006,31,29,2006/2007,8,6,21,15,-Inf
2005/2006,31,30,2006/2007,9,6,26,20,-Inf
2005/2006,31,31,2006/2007,10,4,21,17,-Inf
2005/2006,31,32,2006/2007,11,4,30,26,-Inf
2005/2006,31,33,2006/2007,12,8,45,37,-Inf
2005/2006,31,34,2006/2007,13,14,56,42,-Inf
2005/2006,31,35,2006/2007,14,12,75,63,-Inf
2005/2006,31,36,2006/2007,15,16,83,67,-Inf
2005/2006,31,37,2006/2007,16,10,82,72,-Inf
2005/2006,31,38,2006/2007,17,16,126,110,-Inf
2005/2006,31,39,2006/2007,18,18,119,101,-Inf
2005/2006,31,40,2006/2007,19,15,137,122,-Inf
2005/2006,31,41,2006/2007,20,23,131,108,-Inf
2005/2006,31,42,2006/2007,21,17,112,95,-Inf
2005/2006,31,43,2006/2007,22,33,82,49,-Inf
2005/2006,31,44,2006/2007,23,15,73,58,-Inf
2005/2006,31,45,2006/2007,24,13,43,30,-Inf
2005/2006,31,46,2006/2007,25,11,55,44,-Inf
2005/2006,31,47,2006/2007,26,14,55,41,-Inf
2005/2006,31,48,2006/2007,27,17,53,36,-Inf
2005/2006,31,49,2006/2007,28,19,46,27,-Inf
2005/2006,31,50,2006/2007,29,20,43,23,-Inf
2005/2006,31,51,2006/2007,30,12,29,17,-Inf
2005/2006,31,52,2006/2007,31,21,22,1,-10.41431317630212
2005/2006,32,1,2005/2006,33,13,12,1,-11.512925464970229
2005/2006,32,2,2005/2006,34,17,15,2,-11.512925464970229
2005/2006,32,3,2005/2006,35,8,11,3,-Inf
2005/2006,32,4,2005/2006,36,13,10,3,-Inf
2005/2006,32,5,2005/2006,37,10,15,5,-Inf
2005/2006,32,6,2005/2006,38,17,17,0,-0.4843135292258811
2005/2006,32,7,2005/2006,39,19,7,12,-Inf
2005/2006,32,8,2005/2006,40,9,7,2,-Inf
2005/2006,32,9,2005/2006,41,9,8,1,-10.819778284410283
2005/2006,32,10,2005/2006,42,9,9,0,-0.43280033432822407
2005/2006,32,11,2005/2006,43,3,12,9,-Inf
2005/2006,32,12,2005/2006,44,7,12,5,-Inf
2005/2006,32,13,2005/2006,45,7,5,2,-Inf
2005/2006,32,14,2005/2006,46,0,4,4,-Inf
2005/2006,32,15,2005/2006,47,2,11,9,-Inf
2005/2006,32,16,2005/2006,48,3,4,1,-Inf
2005/2006,32,17,2005/2006,49,3,5,2,-11.512925464970229
2005/2006,32,18,2005/2006,50,1,7,6,-Inf
2005/2006,32,19,2005/2006,51,3,1,2,-10.819778284410283
2005/2006,32,20,2005/2006,52,3,1,2,-Inf
2005/2006,32,21,2006/2007,1,3,4,1,-11.512925464970229
2005/2006,32,22,2006/2007,2,7,2,5,-11.512925464970229
2005/2006,32,23,2006/2007,3,3,6,3,-Inf
2005/2006,32,24,2006/2007,4,5,3,2,-11.512925464970229
2005/2006,32,25,2006/2007,5,11,4,7,-Inf
2005/2006,32,26,2006/2007,6,5,10,5,-Inf
2005/2006,32,27,2006/2007,7,5,12,7,-Inf
2005/2006,32,28,2006/2007,8,6,21,15,-Inf
2005/2006,32,29,2006/2007,9,6,26,20,-Inf
2005/2006,32,30,2006/2007,10,4,21,17,-Inf
2005/2006,32,31,2006/2007,11,4,30,26,-Inf
2005/2006,32,32,2006/2007,12,8,45,37,-Inf
2005/2006,32,33,2006/2007,13,14,56,42,-Inf
2005/2006,32,34,2006/2007,14,12,75,63,-Inf
2005/2006,32,35,2006/2007,15,16,83,67,-Inf
2005/2006,32,36,2006/2007,16,10,82,72,-Inf
2005/2006,32,37,2006/2007,17,16,126,110,-Inf
2005/2006,32,38,2006/2007,18,18,119,101,-Inf
2005/2006,32,39,2006/2007,19,15,137,122,-Inf
2005/2006,32,40,2006/2007,20,23,131,108,-Inf
2005/2006,32,41,2006/2007,21,17,112,95,-Inf
2005/2006,32,42,2006/2007,22,33,82,49,-Inf
2005/2006,32,43,2006/2007,23,15,73,58,-Inf
2005/2006,32,44,2006/2007,24,13,43,30,-11.512925464970229
2005/2006,32,45,2006/2007,25,11,55,44,-Inf
2005/2006,32,46,2006/2007,26,14,55,41,-Inf
2005/2006,32,47,2006/2007,27,17,53,36,-Inf
2005/2006,32,48,2006/2007,28,19,46,27,-Inf
2005/2006,32,49,2006/2007,29,20,43,23,-11.512925464970229
2005/2006,32,50,2006/2007,30,12,29,17,-Inf
2005/2006,32,51,2006/2007,31,21,22,1,-11.512925464970229
2005/2006,32,52,2006/2007,32,7,26,19,-Inf
2005/2006,33,1,2005/2006,34,17,15,2,-Inf
2005/2006,33,2,2005/2006,35,8,11,3,-Inf
2005/2006,33,3,2005/2006,36,13,10,3,-10.126631103850338
2005/2006,33,4,2005/2006,37,10,15,5,-Inf
2005/2006,33,5,2005/2006,38,17,17,0,-0.5006607944671142
2005/2006,33,6,2005/2006,39,19,7,12,-11.512925464970229
2005/2006,33,7,2005/2006,40,9,7,2,-Inf
2005/2006,33,8,2005/2006,41,9,8,1,-10.41431317630212
2005/2006,33,9,2005/2006,42,9,9,0,-0.44307352171517245
2005/2006,33,10,2005/2006,43,3,12,9,-Inf
2005/2006,33,11,2005/2006,44,7,12,5,-Inf
2005/2006,33,12,2005/2006,45,7,5,2,-11.512925464970229
2005/2006,33,13,2005/2006,46,0,4,4,-Inf
2005/2006,33,14,2005/2006,47,2,11,9,-Inf
2005/2006,33,15,2005/2006,48,3,4,1,-11.512925464970229
2005/2006,33,16,2005/2006,49,3,5,2,-Inf
2005/2006,33,17,2005/2006,50,1,7,6,-Inf
2005/2006,33,18,2005/2006,51,3,1,2,-Inf
2005/2006,33,19,2005/2006,52,3,1,2,-Inf
2005/2006,33,20,2006/2007,1,3,4,1,-11.512925464970229
2005/2006,33,21,2006/2007,2,7,2,5,-Inf
2005/2006,33,22,2006/2007,3,3,6,3,-Inf
2005/2006,33,23,2006/2007,4,5,3,2,-11.512925464970229
2005/2006,33,24,2006/2007,5,11,4,7,-Inf
2005/2006,33,25,2006/2007,6,5,10,5,-11.512925464970229
2005/2006,33,26,2006/2007,7,5,12,7,-Inf
2005/2006,33,27,2006/2007,8,6,21,15,-Inf
2005/2006,33,28,2006/2007,9,6,26,20,-Inf
2005/2006,33,29,2006/2007,10,4,21,17,-Inf
2005/2006,33,30,2006/2007,11,4,30,26,-Inf
2005/2006,33,31,2006/2007,12,8,45,37,-Inf
2005/2006,33,32,2006/2007,13,14,56,42,-Inf
2005/2006,33,33,2006/2007,14,12,75,63,-Inf
2005/2006,33,34,2006/2007,15,16,83,67,-Inf
2005/2006,33,35,2006/2007,16,10,82,72,-Inf
2005/2006,33,36,2006/2007,17,16,126,110,-Inf
2005/2006,33,37,2006/2007,18,18,119,101,-Inf
2005/2006,33,38,2006/2007,19,15,137,122,-Inf
2005/2006,33,39,2006/2007,20,23,131,108,-Inf
2005/2006,33,40,2006/2007,21,17,112,95,-Inf
2005/2006,33,41,2006/2007,22,33,82,49,-Inf
2005/2006,33,42,2006/2007,23,15,73,58,-Inf
2005/2006,33,43,2006/2007,24,13,43,30,-Inf
2005/2006,33,44,2006/2007,25,11,55,44,-Inf
2005/2006,33,45,2006/2007,26,14,55,41,-Inf
2005/2006,33,46,2006/2007,27,17,53,36,-Inf
2005/2006,33,47,2006/2007,28,19,46,27,-Inf
2005/2006,33,48,2006/2007,29,20,43,23,-Inf
2005/2006,33,49,2006/2007,30,12,29,17,-Inf
2005/2006,33,50,2006/2007,31,21,22,1,-11.512925464970229
2005/2006,33,51,2006/2007,32,7,26,19,-Inf
2005/2006,33,52,2006/2007,33,19,13,6,-Inf
2005/2006,34,1,2005/2006,35,8,11,3,-Inf
2005/2006,34,2,2005/2006,36,13,10,3,-Inf
2005/2006,34,3,2005/2006,37,10,15,5,-Inf
2005/2006,34,4,2005/2006,38,17,17,0,-0.5189586069961791
2005/2006,34,5,2005/2006,39,19,7,12,-Inf
2005/2006,34,6,2005/2006,40,9,7,2,-10.819778284410283
2005/2006,34,7,2005/2006,41,9,8,1,-10.819778284410283
2005/2006,34,8,2005/2006,42,9,9,0,-0.4535320338775506
2005/2006,34,9,2005/2006,43,3,12,9,-Inf
2005/2006,34,10,2005/2006,44,7,12,5,-Inf
2005/2006,34,11,2005/2006,45,7,5,2,-Inf
2005/2006,34,12,2005/2006,46,0,4,4,-Inf
2005/2006,34,13,2005/2006,47,2,11,9,-Inf
2005/2006,34,14,2005/2006,48,3,4,1,-Inf
2005/2006,34,15,2005/2006,49,3,5,2,-Inf
2005/2006,34,16,2005/2006,50,1,7,6,-Inf
2005/2006,34,17,2005/2006,51,3,1,2,-10.819778284410283
2005/2006,34,18,2005/2006,52,3,1,2,-Inf
2005/2006,34,19,2006/2007,1,3,4,1,-11.512925464970229
2005/2006,34,20,2006/2007,2,7,2,5,-10.819778284410283
2005/2006,34,21,2006/2007,3,3,6,3,-Inf
2005/2006,34,22,2006/2007,4,5,3,2,-11.512925464970229
2005/2006,34,23,2006/2007,5,11,4,7,-Inf
2005/2006,34,24,2006/2007,6,5,10,5,-Inf
2005/2006,34,25,2006/2007,7,5,12,7,-Inf
2005/2006,34,26,2006/2007,8,6,21,15,-Inf
2005/2006,34,27,2006/2007,9,6,26,20,-Inf
2005/2006,34,28,2006/2007,10,4,21,17,-Inf
2005/2006,34,29,2006/2007,11,4,30,26,-Inf
2005/2006,34,30,2006/2007,12,8,45,37,-Inf
2005/2006,34,31,2006/2007,13,14,56,42,-Inf
2005/2006,34,32,2006/2007,14,12,75,63,-Inf
2005/2006,34,33,2006/2007,15,16,83,67,-Inf
2005/2006,34,34,2006/2007,16,10,82,72,-Inf
2005/2006,34,35,2006/2007,17,16,126,110,-Inf
2005/2006,34,36,2006/2007,18,18,119,101,-Inf
2005/2006,34,37,2006/2007,19,15,137,122,-Inf
2005/2006,34,38,2006/2007,20,23,131,108,-Inf
2005/2006,34,39,2006/2007,21,17,112,95,-Inf
2005/2006,34,40,2006/2007,22,33,82,49,-Inf
2005/2006,34,41,2006/2007,23,15,73,58,-Inf
2005/2006,34,42,2006/2007,24,13,43,30,-Inf
2005/2006,34,43,2006/2007,25,11,55,44,-Inf
2005/2006,34,44,2006/2007,26,14,55,41,-Inf
2005/2006,34,45,2006/2007,27,17,53,36,-Inf
2005/2006,34,46,2006/2007,28,19,46,27,-Inf
2005/2006,34,47,2006/2007,29,20,43,23,-Inf
2005/2006,34,48,2006/2007,30,12,29,17,-Inf
2005/2006,34,49,2006/2007,31,21,22,1,-11.512925464970229
2005/2006,34,50,2006/2007,32,7,26,19,-Inf
2005/2006,34,51,2006/2007,33,19,13,6,-Inf
2005/2006,34,52,2006/2007,34,10,17,7,-Inf
2005/2006,35,1,2005/2006,36,13,10,3,-Inf
2005/2006,35,2,2005/2006,37,10,15,5,-Inf
2005/2006,35,3,2005/2006,38,17,17,0,-0.15670059476549625
2005/2006,35,4,2005/2006,39,19,7,12,-Inf
2005/2006,35,5,2005/2006,40,9,7,2,-Inf
2005/2006,35,6,2005/2006,41,9,8,1,-10.819778284410283
2005/2006,35,7,2005/2006,42,9,9,0,-0.1930145233327547
2005/2006,35,8,2005/2006,43,3,12,9,-Inf
2005/2006,35,9,2005/2006,44,7,12,5,-Inf
2005/2006,35,10,2005/2006,45,7,5,2,-11.512925464970229
2005/2006,35,11,2005/2006,46,0,4,4,-Inf
2005/2006,35,12,2005/2006,47,2,11,9,-Inf
2005/2006,35,13,2005/2006,48,3,4,1,-Inf
2005/2006,35,14,2005/2006,49,3,5,2,-Inf
2005/2006,35,15,2005/2006,50,1,7,6,-Inf
2005/2006,35,16,2005/2006,51,3,1,2,-Inf
2005/2006,35,17,2005/2006,52,3,1,2,-Inf
2005/2006,35,18,2006/2007,1,3,4,1,-Inf
2005/2006,35,19,2006/2007,2,7,2,5,-Inf
2005/2006,35,20,2006/2007,3,3,6,3,-11.512925464970229
2005/2006,35,21,2006/2007,4,5,3,2,-11.512925464970229
2005/2006,35,22,2006/2007,5,11,4,7,-Inf
2005/2006,35,23,2006/2007,6,5,10,5,-Inf
2005/2006,35,24,2006/2007,7,5,12,7,-Inf
2005/2006,35,25,2006/2007,8,6,21,15,-11.512925464970229
2005/2006,35,26,2006/2007,9,6,26,20,-Inf
2005/2006,35,27,2006/2007,10,4,21,17,-11.512925464970229
2005/2006,35,28,2006/2007,11,4,30,26,-Inf
2005/2006,35,29,2006/2007,12,8,45,37,-Inf
2005/2006,35,30,2006/2007,13,14,56,42,-Inf
2005/2006,35,31,2006/2007,14,12,75,63,-Inf
2005/2006,35,32,2006/2007,15,16,83,67,-Inf
2005/2006,35,33,2006/2007,16,10,82,72,-Inf
2005/2006,35,34,2006/2007,17,16,126,110,-Inf
2005/2006,35,35,2006/2007,18,18,119,101,-Inf
2005/2006,35,36,2006/2007,19,15,137,122,-Inf
2005/2006,35,37,2006/2007,20,23,131,108,-Inf
2005/2006,35,38,2006/2007,21,17,112,95,-Inf
2005/2006,35,39,2006/2007,22,33,82,49,-Inf
2005/2006,35,40,2006/2007,23,15,73,58,-Inf
2005/2006,35,41,2006/2007,24,13,43,30,-Inf
2005/2006,35,42,2006/2007,25,11,55,44,-Inf
2005/2006,35,43,2006/2007,26,14,55,41,-Inf
2005/2006,35,44,2006/2007,27,17,53,36,-Inf
2005/2006,35,45,2006/2007,28,19,46,27,-Inf
2005/2006,35,46,2006/2007,29,20,43,23,-Inf
2005/2006,35,47,2006/2007,30,12,29,17,-Inf
2005/2006,35,48,2006/2007,31,21,22,1,-Inf
2005/2006,35,49,2006/2007,32,7,26,19,-Inf
2005/2006,35,50,2006/2007,33,19,13,6,-Inf
2005/2006,35,51,2006/2007,34,10,17,7,-Inf
2005/2006,35,52,2006/2007,35,13,8,5,-Inf
2005/2006,36,1,2005/2006,37,10,15,5,-Inf
2005/2006,36,2,2005/2006,38,17,17,0,-0.22647409141066532
2005/2006,36,3,2005/2006,39,19,7,12,-Inf
2005/2006,36,4,2005/2006,40,9,7,2,-11.512925464970229
2005/2006,36,5,2005/2006,41,9,8,1,-11.512925464970229
2005/2006,36,6,2005/2006,42,9,9,0,-0.24923088607752852
2005/2006,36,7,2005/2006,43,3,12,9,-Inf
2005/2006,36,8,2005/2006,44,7,12,5,-Inf
2005/2006,36,9,2005/2006,45,7,5,2,-11.512925464970229
2005/2006,36,10,2005/2006,46,0,4,4,-Inf
2005/2006,36,11,2005/2006,47,2,11,9,-Inf
2005/2006,36,12,2005/2006,48,3,4,1,-11.512925464970229
2005/2006,36,13,2005/2006,49,3,5,2,-Inf
2005/2006,36,14,2005/2006,50,1,7,6,-10.819778284410283
2005/2006,36,15,2005/2006,51,3,1,2,-10.41431317630212
2005/2006,36,16,2005/2006,52,3,1,2,-Inf
2005/2006,36,17,2006/2007,1,3,4,1,-11.512925464970229
2005/2006,36,18,2006/2007,2,7,2,5,-Inf
2005/2006,36,19,2006/2007,3,3,6,3,-Inf
2005/2006,36,20,2006/2007,4,5,3,2,-Inf
2005/2006,36,21,2006/2007,5,11,4,7,-Inf
2005/2006,36,22,2006/2007,6,5,10,5,-Inf
2005/2006,36,23,2006/2007,7,5,12,7,-Inf
2005/2006,36,24,2006/2007,8,6,21,15,-Inf
2005/2006,36,25,2006/2007,9,6,26,20,-Inf
2005/2006,36,26,2006/2007,10,4,21,17,-Inf
2005/2006,36,27,2006/2007,11,4,30,26,-Inf
2005/2006,36,28,2006/2007,12,8,45,37,-Inf
2005/2006,36,29,2006/2007,13,14,56,42,-Inf
2005/2006,36,30,2006/2007,14,12,75,63,-Inf
2005/2006,36,31,2006/2007,15,16,83,67,-Inf
2005/2006,36,32,2006/2007,16,10,82,72,-Inf
2005/2006,36,33,2006/2007,17,16,126,110,-Inf
2005/2006,36,34,2006/2007,18,18,119,101,-Inf
2005/2006,36,35,2006/2007,19,15,137,122,-Inf
2005/2006,36,36,2006/2007,20,23,131,108,-Inf
2005/2006,36,37,2006/2007,21,17,112,95,-Inf
2005/2006,36,38,2006/2007,22,33,82,49,-Inf
2005/2006,36,39,2006/2007,23,15,73,58,-Inf
2005/2006,36,40,2006/2007,24,13,43,30,-Inf
2005/2006,36,41,2006/2007,25,11,55,44,-Inf
2005/2006,36,42,2006/2007,26,14,55,41,-Inf
2005/2006,36,43,2006/2007,27,17,53,36,-Inf
2005/2006,36,44,2006/2007,28,19,46,27,-Inf
2005/2006,36,45,2006/2007,29,20,43,23,-Inf
2005/2006,36,46,2006/2007,30,12,29,17,-Inf
2005/2006,36,47,2006/2007,31,21,22,1,-Inf
2005/2006,36,48,2006/2007,32,7,26,19,-Inf
2005/2006,36,49,2006/2007,33,19,13,6,-Inf
2005/2006,36,50,2006/2007,34,10,17,7,-Inf
2005/2006,36,51,2006/2007,35,13,8,5,-Inf
2005/2006,36,52,2006/2007,36,10,13,3,-Inf
2005/2006,37,1,2005/2006,38,17,17,0,-0.080071874765558
2005/2006,37,2,2005/2006,39,19,7,12,-Inf
2005/2006,37,3,2005/2006,40,9,7,2,-11.512925464970229
2005/2006,37,4,2005/2006,41,9,8,1,-11.512925464970229
2005/2006,37,5,2005/2006,42,9,9,0,-0.15368745379966953
2005/2006,37,6,2005/2006,43,3,12,9,-11.512925464970229
2005/2006,37,7,2005/2006,44,7,12,5,-Inf
2005/2006,37,8,2005/2006,45,7,5,2,-Inf
2005/2006,37,9,2005/2006,46,0,4,4,-Inf
2005/2006,37,10,2005/2006,47,2,11,9,-Inf
2005/2006,37,11,2005/2006,48,3,4,1,-11.512925464970229
2005/2006,37,12,2005/2006,49,3,5,2,-Inf
2005/2006,37,13,2005/2006,50,1,7,6,-Inf
2005/2006,37,14,2005/2006,51,3,1,2,-Inf
2005/2006,37,15,2005/2006,52,3,1,2,-Inf
2005/2006,37,16,2006/2007,1,3,4,1,-Inf
2005/2006,37,17,2006/2007,2,7,2,5,-Inf
2005/2006,37,18,2006/2007,3,3,6,3,-10.819778284410283
2005/2006,37,19,2006/2007,4,5,3,2,-Inf
2005/2006,37,20,2006/2007,5,11,4,7,-Inf
2005/2006,37,21,2006/2007,6,5,10,5,-Inf
2005/2006,37,22,2006/2007,7,5,12,7,-Inf
2005/2006,37,23,2006/2007,8,6,21,15,-Inf
2005/2006,37,24,2006/2007,9,6,26,20,-Inf
2005/2006,37,25,2006/2007,10,4,21,17,-11.512925464970229
2005/2006,37,26,2006/2007,11,4,30,26,-Inf
2005/2006,37,27,2006/2007,12,8,45,37,-Inf
2005/2006,37,28,2006/2007,13,14,56,42,-Inf
2005/2006,37,29,2006/2007,14,12,75,63,-Inf
2005/2006,37,30,2006/2007,15,16,83,67,-Inf
2005/2006,37,31,2006/2007,16,10,82,72,-Inf
2005/2006,37,32,2006/2007,17,16,126,110,-Inf
2005/2006,37,33,2006/2007,18,18,119,101,-Inf
2005/2006,37,34,2006/2007,19,15,137,122,-Inf
2005/2006,37,35,2006/2007,20,23,131,108,-Inf
2005/2006,37,36,2006/2007,21,17,112,95,-Inf
2005/2006,37,37,2006/2007,22,33,82,49,-Inf
2005/2006,37,38,2006/2007,23,15,73,58,-Inf
2005/2006,37,39,2006/2007,24,13,43,30,-Inf
2005/2006,37,40,2006/2007,25,11,55,44,-Inf
2005/2006,37,41,2006/2007,26,14,55,41,-Inf
2005/2006,37,42,2006/2007,27,17,53,36,-Inf
2005/2006,37,43,2006/2007,28,19,46,27,-Inf
2005/2006,37,44,2006/2007,29,20,43,23,-Inf
2005/2006,37,45,2006/2007,30,12,29,17,-Inf
2005/2006,37,46,2006/2007,31,21,22,1,-11.512925464970229
2005/2006,37,47,2006/2007,32,7,26,19,-Inf
2005/2006,37,48,2006/2007,33,19,13,6,-11.512925464970229
2005/2006,37,49,2006/2007,34,10,17,7,-Inf
2005/2006,37,50,2006/2007,35,13,8,5,-Inf
2005/2006,37,51,2006/2007,36,10,13,3,-Inf
2005/2006,37,52,2006/2007,37,8,10,2,-10.41431317630212
2005/2006,38,1,2005/2006,39,19,7,12,-Inf
2005/2006,38,2,2005/2006,40,9,7,2,-Inf
2005/2006,38,3,2005/2006,41,9,8,1,-Inf
2005/2006,38,4,2005/2006,42,9,9,0,-0.1425433067855426
2005/2006,38,5,2005/2006,43,3,12,9,-Inf
2005/2006,38,6,2005/2006,44,7,12,5,-Inf
2005/2006,38,7,2005/2006,45,7,5,2,-11.512925464970229
2005/2006,38,8,2005/2006,46,0,4,4,-Inf
2005/2006,38,9,2005/2006,47,2,11,9,-Inf
2005/2006,38,10,2005/2006,48,3,4,1,-10.819778284410283
2005/2006,38,11,2005/2006,49,3,5,2,-11.512925464970229
2005/2006,38,12,2005/2006,50,1,7,6,-Inf
2005/2006,38,13,2005/2006,51,3,1,2,-11.512925464970229
2005/2006,38,14,2005/2006,52,3,1,2,-11.512925464970229
2005/2006,38,15,2006/2007,1,3,4,1,-11.512925464970229
2005/2006,38,16,2006/2007,2,7,2,5,-Inf
2005/2006,38,17,2006/2007,3,3,6,3,-Inf
2005/2006,38,18,2006/2007,4,5,3,2,-11.512925464970229
2005/2006,38,19,2006/2007,5,11,4,7,-Inf
2005/2006,38,20,2006/2007,6,5,10,5,-Inf
2005/2006,38,21,2006/2007,7,5,12,7,-Inf
2005/2006,38,22,2006/2007,8,6,21,15,-Inf
2005/2006,38,23,2006/2007,9,6,26,20,-Inf
2005/2006,38,24,2006/2007,10,4,21,17,-Inf
2005/2006,38,25,2006/2007,11,4,30,26,-Inf
2005/2006,38,26,2006/2007,12,8,45,37,-Inf
2005/2006,38,27,2006/2007,13,14,56,42,-Inf
2005/2006,38,28,2006/2007,14,12,75,63,-Inf
2005/2006,38,29,2006/2007,15,16,83,67,-Inf
2005/2006,38,30,2006/2007,16,10,82,72,-Inf
2005/2006,38,31,2006/2007,17,16,126,110,-Inf
2005/2006,38,32,2006/2007,18,18,119,101,-Inf
2005/2006,38,33,2006/2007,19,15,137,122,-Inf
2005/2006,38,34,2006/2007,20,23,131,108,-Inf
2005/2006,38,35,2006/2007,21,17,112,95,-Inf
2005/2006,38,36,2006/2007,22,33,82,49,-Inf
2005/2006,38,37,2006/2007,23,15,73,58,-Inf
2005/2006,38,38,2006/2007,24,13,43,30,-Inf
2005/2006,38,39,2006/2007,25,11,55,44,-Inf
2005/2006,38,40,2006/2007,26,14,55,41,-Inf
2005/2006,38,41,2006/2007,27,17,53,36,-Inf
2005/2006,38,42,2006/2007,28,19,46,27,-Inf
2005/2006,38,43,2006/2007,29,20,43,23,-Inf
2005/2006,38,44,2006/2007,30,12,29,17,-Inf
2005/2006,38,45,2006/2007,31,21,22,1,-11.512925464970229
2005/2006,38,46,2006/2007,32,7,26,19,-Inf
2005/2006,38,47,2006/2007,33,19,13,6,-Inf
2005/2006,38,48,2006/2007,34,10,17,7,-Inf
2005/2006,38,49,2006/2007,35,13,8,5,-Inf
2005/2006,38,50,2006/2007,36,10,13,3,-Inf
2005/2006,38,51,2006/2007,37,8,10,2,-Inf
2005/2006,38,52,2006/2007,38,21,17,4,-Inf
2005/2006,39,1,2005/2006,40,9,7,2,-Inf
2005/2006,39,2,2005/2006,41,9,8,1,-10.819778284410283
2005/2006,39,3,2005/2006,42,9,9,0,-0.1079082027026157
2005/2006,39,4,2005/2006,43,3,12,9,-Inf
2005/2006,39,5,2005/2006,44,7,12,5,-Inf
2005/2006,39,6,2005/2006,45,7,5,2,-10.126631103850338
2005/2006,39,7,2005/2006,46,0,4,4,-Inf
2005/2006,39,8,2005/2006,47,2,11,9,-Inf
2005/2006,39,9,2005/2006,48,3,4,1,-Inf
2005/2006,39,10,2005/2006,49,3,5,2,-Inf
2005/2006,39,11,2005/2006,50,1,7,6,-Inf
2005/2006,39,12,2005/2006,51,3,1,2,-11.512925464970229
2005/2006,39,13,2005/2006,52,3,1,2,-Inf
2005/2006,39,14,2006/2007,1,3,4,1,-11.512925464970229
2005/2006,39,15,2006/2007,2,7,2,5,-11.512925464970229
2005/2006,39,16,2006/2007,3,3,6,3,-Inf
2005/2006,39,17,2006/2007,4,5,3,2,-Inf
2005/2006,39,18,2006/2007,5,11,4,7,-Inf
2005/2006,39,19,2006/2007,6,5,10,5,-Inf
2005/2006,39,20,2006/2007,7,5,12,7,-Inf
2005/2006,39,21,2006/2007,8,6,21,15,-11.512925464970229
2005/2006,39,22,2006/2007,9,6,26,20,-Inf
2005/2006,39,23,2006/2007,10,4,21,17,-Inf
2005/2006,39,24,2006/2007,11,4,30,26,-Inf
2005/2006,39,25,2006/2007,12,8,45,37,-Inf
2005/2006,39,26,2006/2007,13,14,56,42,-Inf
2005/2006,39,27,2006/2007,14,12,75,63,-Inf
2005/2006,39,28,2006/2007,15,16,83,67,-Inf
2005/2006,39,29,2006/2007,16,10,82,72,-Inf
2005/2006,39,30,2006/2007,17,16,126,110,-11.512925464970229
2005/2006,39,31,2006/2007,18,18,119,101,-Inf
2005/2006,39,32,2006/2007,19,15,137,122,-Inf
2005/2006,39,33,2006/2007,20,23,131,108,-Inf
2005/2006,39,34,2006/2007,21,17,112,95,-Inf
2005/2006,39,35,2006/2007,22,33,82,49,-Inf
2005/2006,39,36,2006/2007,23,15,73,58,-Inf
2005/2006,39,37,2006/2007,24,13,43,30,-Inf
2005/2006,39,38,2006/2007,25,11,55,44,-Inf
2005/2006,39,39,2006/2007,26,14,55,41,-Inf
2005/2006,39,40,2006/2007,27,17,53,36,-Inf
2005/2006,39,41,2006/2007,28,19,46,27,-Inf
2005/2006,39,42,2006/2007,29,20,43,23,-Inf
2005/2006,39,43,2006/2007,30,12,29,17,-10.819778284410283
2005/2006,39,44,2006/2007,31,21,22,1,-10.819778284410283
2005/2006,39,45,2006/2007,32,7,26,19,-Inf
2005/2006,39,46,2006/2007,33,19,13,6,-Inf
2005/2006,39,47,2006/2007,34,10,17,7,-Inf
2005/2006,39,48,2006/2007,35,13,8,5,-Inf
2005/2006,39,49,2006/2007,36,10,13,3,-Inf
2005/2006,39,50,2006/2007,37,8,10,2,-Inf
2005/2006,39,51,2006/2007,38,21,17,4,-Inf
2005/2006,39,52,2006/2007,39,11,19,8,-Inf
2005/2006,3,1,2005/2006,4,3,3,0,-0.11984265521733839
2005/2006,3,2,2005/2006,5,4,12,8,-11.512925464970229
2005/2006,3,3,2005/2006,6,10,13,3,-Inf
2005/2006,3,4,2005/2006,7,12,10,2,-Inf
2005/2006,3,5,2005/2006,8,21,13,8,-11.512925464970229
2005/2006,3,6,2005/2006,9,26,13,13,-Inf
2005/2006,3,7,2005/2006,10,21,8,13,-Inf
2005/2006,3,8,2005/2006,11,30,21,9,-Inf
2005/2006,3,9,2005/2006,12,45,18,27,-Inf
2005/2006,3,10,2005/2006,13,56,8,48,-11.512925464970229
2005/2006,3,11,2005/2006,14,75,7,68,-Inf
2005/2006,3,12,2005/2006,15,83,20,63,-Inf
2005/2006,3,13,2005/2006,16,82,14,68,-Inf
2005/2006,3,14,2005/2006,17,126,14,112,-Inf
2005/2006,3,15,2005/2006,18,119,7,112,-Inf
2005/2006,3,16,2005/2006,19,137,14,123,-Inf
2005/2006,3,17,2005/2006,20,131,10,121,-Inf
2005/2006,3,18,2005/2006,21,112,13,99,-Inf
2005/2006,3,19,2005/2006,22,82,27,55,-Inf
2005/2006,3,20,2005/2006,23,73,13,60,-Inf
2005/2006,3,21,2005/2006,24,43,18,25,-Inf
2005/2006,3,22,2005/2006,25,55,16,39,-Inf
2005/2006,3,23,2005/2006,26,55,16,39,-Inf
2005/2006,3,24,2005/2006,27,53,20,33,-Inf
2005/2006,3,25,2005/2006,28,46,17,29,-Inf
2005/2006,3,26,2005/2006,29,43,4,39,-Inf
2005/2006,3,27,2005/2006,30,29,15,14,-Inf
2005/2006,3,28,2005/2006,31,22,8,14,-Inf
2005/2006,3,29,2005/2006,32,26,6,20,-Inf
2005/2006,3,30,2005/2006,33,13,12,1,-Inf
2005/2006,3,31,2005/2006,34,17,15,2,-Inf
2005/2006,3,32,2005/2006,35,8,11,3,-Inf
2005/2006,3,33,2005/2006,36,13,10,3,-Inf
2005/2006,3,34,2005/2006,37,10,15,5,-Inf
2005/2006,3,35,2005/2006,38,17,17,0,-0.3240556425661403
2005/2006,3,36,2005/2006,39,19,7,12,-Inf
2005/2006,3,37,2005/2006,40,9,7,2,-Inf
2005/2006,3,38,2005/2006,41,9,8,1,-11.512925464970229
2005/2006,3,39,2005/2006,42,9,9,0,-0.3315503689084416
2005/2006,3,40,2005/2006,43,3,12,9,-Inf
2005/2006,3,41,2005/2006,44,7,12,5,-Inf
2005/2006,3,42,2005/2006,45,7,5,2,-Inf
2005/2006,3,43,2005/2006,46,0,4,4,-Inf
2005/2006,3,44,2005/2006,47,2,11,9,-Inf
2005/2006,3,45,2005/2006,48,3,4,1,-Inf
2005/2006,3,46,2005/2006,49,3,5,2,-Inf
2005/2006,3,47,2005/2006,50,1,7,6,-10.819778284410283
2005/2006,3,48,2005/2006,51,3,1,2,-Inf
2005/2006,3,49,2005/2006,52,3,1,2,-11.512925464970229
2005/2006,3,50,2006/2007,1,3,4,1,-11.512925464970229
2005/2006,3,51,2006/2007,2,7,2,5,-Inf
2005/2006,3,52,2006/2007,3,3,6,3,-Inf
2005/2006,40,1,2005/2006,41,9,8,1,-10.819778284410283
2005/2006,40,2,2005/2006,42,9,9,0,-0.13846927822558008
2005/2006,40,3,2005/2006,43,3,12,9,-11.512925464970229
2005/2006,40,4,2005/2006,44,7,12,5,-Inf
2005/2006,40,5,2005/2006,45,7,5,2,-Inf
2005/2006,40,6,2005/2006,46,0,4,4,-Inf
2005/2006,40,7,2005/2006,47,2,11,9,-Inf
2005/2006,40,8,2005/2006,48,3,4,1,-Inf
2005/2006,40,9,2005/2006,49,3,5,2,-Inf
2005/2006,40,10,2005/2006,50,1,7,6,-Inf
2005/2006,40,11,2005/2006,51,3,1,2,-11.512925464970229
2005/2006,40,12,2005/2006,52,3,1,2,-11.512925464970229
2005/2006,40,13,2006/2007,1,3,4,1,-Inf
2005/2006,40,14,2006/2007,2,7,2,5,-Inf
2005/2006,40,15,2006/2007,3,3,6,3,-Inf
2005/2006,40,16,2006/2007,4,5,3,2,-Inf
2005/2006,40,17,2006/2007,5,11,4,7,-Inf
2005/2006,40,18,2006/2007,6,5,10,5,-Inf
2005/2006,40,19,2006/2007,7,5,12,7,-11.512925464970229
2005/2006,40,20,2006/2007,8,6,21,15,-Inf
2005/2006,40,21,2006/2007,9,6,26,20,-Inf
2005/2006,40,22,2006/2007,10,4,21,17,-Inf
2005/2006,40,23,2006/2007,11,4,30,26,-Inf
2005/2006,40,24,2006/2007,12,8,45,37,-Inf
2005/2006,40,25,2006/2007,13,14,56,42,-Inf
2005/2006,40,26,2006/2007,14,12,75,63,-Inf
2005/2006,40,27,2006/2007,15,16,83,67,-Inf
2005/2006,40,28,2006/2007,16,10,82,72,-Inf
2005/2006,40,29,2006/2007,17,16,126,110,-Inf
2005/2006,40,30,2006/2007,18,18,119,101,-Inf
2005/2006,40,31,2006/2007,19,15,137,122,-Inf
2005/2006,40,32,2006/2007,20,23,131,108,-Inf
2005/2006,40,33,2006/2007,21,17,112,95,-Inf
2005/2006,40,34,2006/2007,22,33,82,49,-Inf
2005/2006,40,35,2006/2007,23,15,73,58,-Inf
2005/2006,40,36,2006/2007,24,13,43,30,-Inf
2005/2006,40,37,2006/2007,25,11,55,44,-Inf
2005/2006,40,38,2006/2007,26,14,55,41,-Inf
2005/2006,40,39,2006/2007,27,17,53,36,-Inf
2005/2006,40,40,2006/2007,28,19,46,27,-Inf
2005/2006,40,41,2006/2007,29,20,43,23,-Inf
2005/2006,40,42,2006/2007,30,12,29,17,-Inf
2005/2006,40,43,2006/2007,31,21,22,1,-11.512925464970229
2005/2006,40,44,2006/2007,32,7,26,19,-Inf
2005/2006,40,45,2006/2007,33,19,13,6,-Inf
2005/2006,40,46,2006/2007,34,10,17,7,-Inf
2005/2006,40,47,2006/2007,35,13,8,5,-Inf
2005/2006,40,48,2006/2007,36,10,13,3,-Inf
2005/2006,40,49,2006/2007,37,8,10,2,-11.512925464970229
2005/2006,40,50,2006/2007,38,21,17,4,-Inf
2005/2006,40,51,2006/2007,39,11,19,8,-Inf
2005/2006,40,52,2006/2007,40,9,9,0,-0.3461448660369957
2005/2006,41,1,2005/2006,42,9,9,0,-0.17872005001228786
2005/2006,41,2,2005/2006,43,3,12,9,-Inf
2005/2006,41,3,2005/2006,44,7,12,5,-Inf
2005/2006,41,4,2005/2006,45,7,5,2,-10.819778284410283
2005/2006,41,5,2005/2006,46,0,4,4,-11.512925464970229
2005/2006,41,6,2005/2006,47,2,11,9,-Inf
2005/2006,41,7,2005/2006,48,3,4,1,-11.512925464970229
2005/2006,41,8,2005/2006,49,3,5,2,-Inf
2005/2006,41,9,2005/2006,50,1,7,6,-Inf
2005/2006,41,10,2005/2006,51,3,1,2,-Inf
2005/2006,41,11,2005/2006,52,3,1,2,-Inf
2005/2006,41,12,2006/2007,1,3,4,1,-11.512925464970229
2005/2006,41,13,2006/2007,2,7,2,5,-11.512925464970229
2005/2006,41,14,2006/2007,3,3,6,3,-Inf
2005/2006,41,15,2006/2007,4,5,3,2,-Inf
2005/2006,41,16,2006/2007,5,11,4,7,-Inf
2005/2006,41,17,2006/2007,6,5,10,5,-Inf
2005/2006,41,18,2006/2007,7,5,12,7,-Inf
2005/2006,41,19,2006/2007,8,6,21,15,-Inf
2005/2006,41,20,2006/2007,9,6,26,20,-Inf
2005/2006,41,21,2006/2007,10,4,21,17,-Inf
2005/2006,41,22,2006/2007,11,4,30,26,-Inf
2005/2006,41,23,2006/2007,12,8,45,37,-Inf
2005/2006,41,24,2006/2007,13,14,56,42,-Inf
2005/2006,41,25,2006/2007,14,12,75,63,-Inf
2005/2006,41,26,2006/2007,15,16,83,67,-Inf
2005/2006,41,27,2006/2007,16,10,82,72,-Inf
2005/2006,41,28,2006/2007,17,16,126,110,-Inf
2005/2006,41,29,2006/2007,18,18,119,101,-Inf
2005/2006,41,30,2006/2007,19,15,137,122,-Inf
2005/2006,41,31,2006/2007,20,23,131,108,-Inf
2005/2006,41,32,2006/2007,21,17,112,95,-Inf
2005/2006,41,33,2006/2007,22,33,82,49,-Inf
2005/2006,41,34,2006/2007,23,15,73,58,-Inf
2005/2006,41,35,2006/2007,24,13,43,30,-Inf
2005/2006,41,36,2006/2007,25,11,55,44,-Inf
2005/2006,41,37,2006/2007,26,14,55,41,-Inf
2005/2006,41,38,2006/2007,27,17,53,36,-Inf
2005/2006,41,39,2006/2007,28,19,46,27,-Inf
2005/2006,41,40,2006/2007,29,20,43,23,-Inf
2005/2006,41,41,2006/2007,30,12,29,17,-Inf
2005/2006,41,42,2006/2007,31,21,22,1,-Inf
2005/2006,41,43,2006/2007,32,7,26,19,-Inf
2005/2006,41,44,2006/2007,33,19,13,6,-Inf
2005/2006,41,45,2006/2007,34,10,17,7,-11.512925464970229
2005/2006,41,46,2006/2007,35,13,8,5,-Inf
2005/2006,41,47,2006/2007,36,10,13,3,-Inf
2005/2006,41,48,2006/2007,37,8,10,2,-10.41431317630212
2005/2006,41,49,2006/2007,38,21,17,4,-Inf
2005/2006,41,50,2006/2007,39,11,19,8,-Inf
2005/2006,41,51,2006/2007,40,9,9,0,-0.3494865566988974
2005/2006,41,52,2006/2007,41,14,9,5,-Inf
2005/2006,42,1,2005/2006,43,3,12,9,-Inf
2005/2006,42,2,2005/2006,44,7,12,5,-Inf
2005/2006,42,3,2005/2006,45,7,5,2,-10.819778284410283
2005/2006,42,4,2005/2006,46,0,4,4,-Inf
2005/2006,42,5,2005/2006,47,2,11,9,-Inf
2005/2006,42,6,2005/2006,48,3,4,1,-Inf
2005/2006,42,7,2005/2006,49,3,5,2,-Inf
2005/2006,42,8,2005/2006,50,1,7,6,-Inf
2005/2006,42,9,2005/2006,51,3,1,2,-Inf
2005/2006,42,10,2005/2006,52,3,1,2,-10.819778284410283
2005/2006,42,11,2006/2007,1,3,4,1,-Inf
2005/2006,42,12,2006/2007,2,7,2,5,-Inf
2005/2006,42,13,2006/2007,3,3,6,3,-Inf
2005/2006,42,14,2006/2007,4,5,3,2,-10.819778284410283
2005/2006,42,15,2006/2007,5,11,4,7,-Inf
2005/2006,42,16,2006/2007,6,5,10,5,-Inf
2005/2006,42,17,2006/2007,7,5,12,7,-Inf
2005/2006,42,18,2006/2007,8,6,21,15,-Inf
2005/2006,42,19,2006/2007,9,6,26,20,-Inf
2005/2006,42,20,2006/2007,10,4,21,17,-Inf
2005/2006,42,21,2006/2007,11,4,30,26,-Inf
2005/2006,42,22,2006/2007,12,8,45,37,-Inf
2005/2006,42,23,2006/2007,13,14,56,42,-Inf
2005/2006,42,24,2006/2007,14,12,75,63,-Inf
2005/2006,42,25,2006/2007,15,16,83,67,-Inf
2005/2006,42,26,2006/2007,16,10,82,72,-Inf
2005/2006,42,27,2006/2007,17,16,126,110,-Inf
2005/2006,42,28,2006/2007,18,18,119,101,-Inf
2005/2006,42,29,2006/2007,19,15,137,122,-Inf
2005/2006,42,30,2006/2007,20,23,131,108,-Inf
2005/2006,42,31,2006/2007,21,17,112,95,-Inf
2005/2006,42,32,2006/2007,22,33,82,49,-Inf
2005/2006,42,33,2006/2007,23,15,73,58,-Inf
2005/2006,42,34,2006/2007,24,13,43,30,-Inf
2005/2006,42,35,2006/2007,25,11,55,44,-Inf
2005/2006,42,36,2006/2007,26,14,55,41,-Inf
2005/2006,42,37,2006/2007,27,17,53,36,-Inf
2005/2006,42,38,2006/2007,28,19,46,27,-Inf
2005/2006,42,39,2006/2007,29,20,43,23,-Inf
2005/2006,42,40,2006/2007,30,12,29,17,-Inf
2005/2006,42,41,2006/2007,31,21,22,1,-Inf
2005/2006,42,42,2006/2007,32,7,26,19,-Inf
2005/2006,42,43,2006/2007,33,19,13,6,-Inf
2005/2006,42,44,2006/2007,34,10,17,7,-Inf
2005/2006,42,45,2006/2007,35,13,8,5,-Inf
2005/2006,42,46,2006/2007,36,10,13,3,-Inf
2005/2006,42,47,2006/2007,37,8,10,2,-Inf
2005/2006,42,48,2006/2007,38,21,17,4,-Inf
2005/2006,42,49,2006/2007,39,11,19,8,-Inf
2005/2006,42,50,2006/2007,40,9,9,0,-0.34734715477351585
2005/2006,42,51,2006/2007,41,14,9,5,-11.512925464970229
2005/2006,42,52,2006/2007,42,14,9,5,-Inf
2005/2006,43,1,2005/2006,44,7,12,5,-11.512925464970229
2005/2006,43,2,2005/2006,45,7,5,2,-Inf
2005/2006,43,3,2005/2006,46,0,4,4,-Inf
2005/2006,43,4,2005/2006,47,2,11,9,-Inf
2005/2006,43,5,2005/2006,48,3,4,1,-11.512925464970229
2005/2006,43,6,2005/2006,49,3,5,2,-11.512925464970229
2005/2006,43,7,2005/2006,50,1,7,6,-Inf
2005/2006,43,8,2005/2006,51,3,1,2,-Inf
2005/2006,43,9,2005/2006,52,3,1,2,-Inf
2005/2006,43,10,2006/2007,1,3,4,1,-Inf
2005/2006,43,11,2006/2007,2,7,2,5,-Inf
2005/2006,43,12,2006/2007,3,3,6,3,-Inf
2005/2006,43,13,2006/2007,4,5,3,2,-Inf
2005/2006,43,14,2006/2007,5,11,4,7,-11.512925464970229
2005/2006,43,15,2006/2007,6,5,10,5,-Inf
2005/2006,43,16,2006/2007,7,5,12,7,-Inf
2005/2006,43,17,2006/2007,8,6,21,15,-Inf
2005/2006,43,18,2006/2007,9,6,26,20,-Inf
2005/2006,43,19,2006/2007,10,4,21,17,-Inf
2005/2006,43,20,2006/2007,11,4,30,26,-Inf
2005/2006,43,21,2006/2007,12,8,45,37,-Inf
2005/2006,43,22,2006/2007,13,14,56,42,-Inf
2005/2006,43,23,2006/2007,14,12,75,63,-Inf
2005/2006,43,24,2006/2007,15,16,83,67,-Inf
2005/2006,43,25,2006/2007,16,10,82,72,-Inf
2005/2006,43,26,2006/2007,17,16,126,110,-Inf
2005/2006,43,27,2006/2007,18,18,119,101,-Inf
2005/2006,43,28,2006/2007,19,15,137,122,-Inf
2005/2006,43,29,2006/2007,20,23,131,108,-Inf
2005/2006,43,30,2006/2007,21,17,112,95,-Inf
2005/2006,43,31,2006/2007,22,33,82,49,-Inf
2005/2006,43,32,2006/2007,23,15,73,58,-Inf
2005/2006,43,33,2006/2007,24,13,43,30,-Inf
2005/2006,43,34,2006/2007,25,11,55,44,-Inf
2005/2006,43,35,2006/2007,26,14,55,41,-Inf
2005/2006,43,36,2006/2007,27,17,53,36,-Inf
2005/2006,43,37,2006/2007,28,19,46,27,-Inf
2005/2006,43,38,2006/2007,29,20,43,23,-Inf
2005/2006,43,39,2006/2007,30,12,29,17,-Inf
2005/2006,43,40,2006/2007,31,21,22,1,-Inf
2005/2006,43,41,2006/2007,32,7,26,19,-Inf
2005/2006,43,42,2006/2007,33,19,13,6,-Inf
2005/2006,43,43,2006/2007,34,10,17,7,-Inf
2005/2006,43,44,2006/2007,35,13,8,5,-Inf
2005/2006,43,45,2006/2007,36,10,13,3,-11.512925464970229
2005/2006,43,46,2006/2007,37,8,10,2,-Inf
2005/2006,43,47,2006/2007,38,21,17,4,-Inf
2005/2006,43,48,2006/2007,39,11,19,8,-Inf
2005/2006,43,49,2006/2007,40,9,9,0,-0.3387508306459601
2005/2006,43,50,2006/2007,41,14,9,5,-10.41431317630212
2005/2006,43,51,2006/2007,42,14,9,5,-Inf
2005/2006,43,52,2006/2007,43,15,3,12,-Inf
2005/2006,44,1,2005/2006,45,7,5,2,-Inf
2005/2006,44,2,2005/2006,46,0,4,4,-10.819778284410283
2005/2006,44,3,2005/2006,47,2,11,9,-Inf
2005/2006,44,4,2005/2006,48,3,4,1,-10.41431317630212
2005/2006,44,5,2005/2006,49,3,5,2,-11.512925464970229
2005/2006,44,6,2005/2006,50,1,7,6,-Inf
2005/2006,44,7,2005/2006,51,3,1,2,-Inf
2005/2006,44,8,2005/2006,52,3,1,2,-Inf
2005/2006,44,9,2006/2007,1,3,4,1,-10.41431317630212
2005/2006,44,10,2006/2007,2,7,2,5,-Inf
2005/2006,44,11,2006/2007,3,3,6,3,-Inf
2005/2006,44,12,2006/2007,4,5,3,2,-Inf
2005/2006,44,13,2006/2007,5,11,4,7,-Inf
2005/2006,44,14,2006/2007,6,5,10,5,-Inf
2005/2006,44,15,2006/2007,7,5,12,7,-11.512925464970229
2005/2006,44,16,2006/2007,8,6,21,15,-Inf
2005/2006,44,17,2006/2007,9,6,26,20,-Inf
2005/2006,44,18,2006/2007,10,4,21,17,-Inf
2005/2006,44,19,2006/2007,11,4,30,26,-Inf
2005/2006,44,20,2006/2007,12,8,45,37,-Inf
2005/2006,44,21,2006/2007,13,14,56,42,-Inf
2005/2006,44,22,2006/2007,14,12,75,63,-Inf
2005/2006,44,23,2006/2007,15,16,83,67,-Inf
2005/2006,44,24,2006/2007,16,10,82,72,-Inf
2005/2006,44,25,2006/2007,17,16,126,110,-Inf
2005/2006,44,26,2006/2007,18,18,119,101,-Inf
2005/2006,44,27,2006/2007,19,15,137,122,-Inf
2005/2006,44,28,2006/2007,20,23,131,108,-Inf
2005/2006,44,29,2006/2007,21,17,112,95,-Inf
2005/2006,44,30,2006/2007,22,33,82,49,-Inf
2005/2006,44,31,2006/2007,23,15,73,58,-Inf
2005/2006,44,32,2006/2007,24,13,43,30,-Inf
2005/2006,44,33,2006/2007,25,11,55,44,-Inf
2005/2006,44,34,2006/2007,26,14,55,41,-Inf
2005/2006,44,35,2006/2007,27,17,53,36,-Inf
2005/2006,44,36,2006/2007,28,19,46,27,-Inf
2005/2006,44,37,2006/2007,29,20,43,23,-Inf
2005/2006,44,38,2006/2007,30,12,29,17,-Inf
2005/2006,44,39,2006/2007,31,21,22,1,-11.512925464970229
2005/2006,44,40,2006/2007,32,7,26,19,-Inf
2005/2006,44,41,2006/2007,33,19,13,6,-Inf
2005/2006,44,42,2006/2007,34,10,17,7,-11.512925464970229
2005/2006,44,43,2006/2007,35,13,8,5,-10.819778284410283
2005/2006,44,44,2006/2007,36,10,13,3,-Inf
2005/2006,44,45,2006/2007,37,8,10,2,-11.512925464970229
2005/2006,44,46,2006/2007,38,21,17,4,-Inf
2005/2006,44,47,2006/2007,39,11,19,8,-Inf
2005/2006,44,48,2006/2007,40,9,9,0,-0.3454241860230418
2005/2006,44,49,2006/2007,41,14,9,5,-11.512925464970229
2005/2006,44,50,2006/2007,42,14,9,5,-Inf
2005/2006,44,51,2006/2007,43,15,3,12,-Inf
2005/2006,44,52,2006/2007,44,18,7,11,-Inf
2005/2006,45,1,2005/2006,46,0,4,4,-Inf
2005/2006,45,2,2005/2006,47,2,11,9,-Inf
2005/2006,45,3,2005/2006,48,3,4,1,-11.512925464970229
2005/2006,45,4,2005/2006,49,3,5,2,-11.512925464970229
2005/2006,45,5,2005/2006,50,1,7,6,-Inf
2005/2006,45,6,2005/2006,51,3,1,2,-Inf
2005/2006,45,7,2005/2006,52,3,1,2,-Inf
2005/2006,45,8,2006/2007,1,3,4,1,-Inf
2005/2006,45,9,2006/2007,2,7,2,5,-Inf
2005/2006,45,10,2006/2007,3,3,6,3,-11.512925464970229
2005/2006,45,11,2006/2007,4,5,3,2,-Inf
2005/2006,45,12,2006/2007,5,11,4,7,-Inf
2005/2006,45,13,2006/2007,6,5,10,5,-10.819778284410283
2005/2006,45,14,2006/2007,7,5,12,7,-Inf
2005/2006,45,15,2006/2007,8,6,21,15,-Inf
2005/2006,45,16,2006/2007,9,6,26,20,-Inf
2005/2006,45,17,2006/2007,10,4,21,17,-Inf
2005/2006,45,18,2006/2007,11,4,30,26,-Inf
2005/2006,45,19,2006/2007,12,8,45,37,-Inf
2005/2006,45,20,2006/2007,13,14,56,42,-Inf
2005/2006,45,21,2006/2007,14,12,75,63,-Inf
2005/2006,45,22,2006/2007,15,16,83,67,-Inf
2005/2006,45,23,2006/2007,16,10,82,72,-Inf
2005/2006,45,24,2006/2007,17,16,126,110,-Inf
2005/2006,45,25,2006/2007,18,18,119,101,-Inf
2005/2006,45,26,2006/2007,19,15,137,122,-Inf
2005/2006,45,27,2006/2007,20,23,131,108,-Inf
2005/2006,45,28,2006/2007,21,17,112,95,-Inf
2005/2006,45,29,2006/2007,22,33,82,49,-Inf
2005/2006,45,30,2006/2007,23,15,73,58,-Inf
2005/2006,45,31,2006/2007,24,13,43,30,-Inf
2005/2006,45,32,2006/2007,25,11,55,44,-Inf
2005/2006,45,33,2006/2007,26,14,55,41,-11.512925464970229
2005/2006,45,34,2006/2007,27,17,53,36,-Inf
2005/2006,45,35,2006/2007,28,19,46,27,-Inf
2005/2006,45,36,2006/2007,29,20,43,23,-Inf
2005/2006,45,37,2006/2007,30,12,29,17,-Inf
2005/2006,45,38,2006/2007,31,21,22,1,-Inf
2005/2006,45,39,2006/2007,32,7,26,19,-Inf
2005/2006,45,40,2006/2007,33,19,13,6,-Inf
2005/2006,45,41,2006/2007,34,10,17,7,-Inf
2005/2006,45,42,2006/2007,35,13,8,5,-Inf
2005/2006,45,43,2006/2007,36,10,13,3,-11.512925464970229
2005/2006,45,44,2006/2007,37,8,10,2,-10.819778284410283
2005/2006,45,45,2006/2007,38,21,17,4,-Inf
2005/2006,45,46,2006/2007,39,11,19,8,-Inf
2005/2006,45,47,2006/2007,40,9,9,0,-0.3401971655630813
2005/2006,45,48,2006/2007,41,14,9,5,-Inf
2005/2006,45,49,2006/2007,42,14,9,5,-Inf
2005/2006,45,50,2006/2007,43,15,3,12,-Inf
2005/2006,45,51,2006/2007,44,18,7,11,-Inf
2005/2006,45,52,2006/2007,45,16,7,9,-Inf
2005/2006,46,1,2005/2006,47,2,11,9,-Inf
2005/2006,46,2,2005/2006,48,3,4,1,-Inf
2005/2006,46,3,2005/2006,49,3,5,2,-Inf
2005/2006,46,4,2005/2006,50,1,7,6,-Inf
2005/2006,46,5,2005/2006,51,3,1,2,-11.512925464970229
2005/2006,46,6,2005/2006,52,3,1,2,-Inf
2005/2006,46,7,2006/2007,1,3,4,1,-Inf
2005/2006,46,8,2006/2007,2,7,2,5,-Inf
2005/2006,46,9,2006/2007,3,3,6,3,-10.819778284410283
2005/2006,46,10,2006/2007,4,5,3,2,-10.819778284410283
2005/2006,46,11,2006/2007,5,11,4,7,-Inf
2005/2006,46,12,2006/2007,6,5,10,5,-Inf
2005/2006,46,13,2006/2007,7,5,12,7,-Inf
2005/2006,46,14,2006/2007,8,6,21,15,-Inf
2005/2006,46,15,2006/2007,9,6,26,20,-Inf
2005/2006,46,16,2006/2007,10,4,21,17,-Inf
2005/2006,46,17,2006/2007,11,4,30,26,-Inf
2005/2006,46,18,2006/2007,12,8,45,37,-Inf
2005/2006,46,19,2006/2007,13,14,56,42,-Inf
2005/2006,46,20,2006/2007,14,12,75,63,-Inf
2005/2006,46,21,2006/2007,15,16,83,67,-Inf
2005/2006,46,22,2006/2007,16,10,82,72,-Inf
2005/2006,46,23,2006/2007,17,16,126,110,-Inf
2005/2006,46,24,2006/2007,18,18,119,101,-Inf
2005/2006,46,25,2006/2007,19,15,137,122,-Inf
2005/2006,46,26,2006/2007,20,23,131,108,-Inf
2005/2006,46,27,2006/2007,21,17,112,95,-Inf
2005/2006,46,28,2006/2007,22,33,82,49,-Inf
2005/2006,46,29,2006/2007,23,15,73,58,-Inf
2005/2006,46,30,2006/2007,24,13,43,30,-Inf
2005/2006,46,31,2006/2007,25,11,55,44,-Inf
2005/2006,46,32,2006/2007,26,14,55,41,-Inf
2005/2006,46,33,2006/2007,27,17,53,36,-Inf
2005/2006,46,34,2006/2007,28,19,46,27,-Inf
2005/2006,46,35,2006/2007,29,20,43,23,-Inf
2005/2006,46,36,2006/2007,30,12,29,17,-Inf
2005/2006,46,37,2006/2007,31,21,22,1,-11.512925464970229
2005/2006,46,38,2006/2007,32,7,26,19,-Inf
2005/2006,46,39,2006/2007,33,19,13,6,-11.512925464970229
2005/2006,46,40,2006/2007,34,10,17,7,-11.512925464970229
2005/2006,46,41,2006/2007,35,13,8,5,-Inf
2005/2006,46,42,2006/2007,36,10,13,3,-11.512925464970229
2005/2006,46,43,2006/2007,37,8,10,2,-11.512925464970229
2005/2006,46,44,2006/2007,38,21,17,4,-Inf
2005/2006,46,45,2006/2007,39,11,19,8,-Inf
2005/2006,46,46,2006/2007,40,9,9,0,-0.3436177047820852
2005/2006,46,47,2006/2007,41,14,9,5,-Inf
2005/2006,46,48,2006/2007,42,14,9,5,-Inf
2005/2006,46,49,2006/2007,43,15,3,12,-Inf
2005/2006,46,50,2006/2007,44,18,7,11,-Inf
2005/2006,46,51,2006/2007,45,16,7,9,-Inf
2005/2006,46,52,2006/2007,46,12,0,12,-Inf
2005/2006,47,1,2005/2006,48,3,4,1,-10.819778284410283
2005/2006,47,2,2005/2006,49,3,5,2,-11.512925464970229
2005/2006,47,3,2005/2006,50,1,7,6,-11.512925464970229
2005/2006,47,4,2005/2006,51,3,1,2,-Inf
2005/2006,47,5,2005/2006,52,3,1,2,-Inf
2005/2006,47,6,2006/2007,1,3,4,1,-9.721165995742174
2005/2006,47,7,2006/2007,2,7,2,5,-11.512925464970229
2005/2006,47,8,2006/2007,3,3,6,3,-11.512925464970229
2005/2006,47,9,2006/2007,4,5,3,2,-Inf
2005/2006,47,10,2006/2007,5,11,4,7,-Inf
2005/2006,47,11,2006/2007,6,5,10,5,-Inf
2005/2006,47,12,2006/2007,7,5,12,7,-Inf
2005/2006,47,13,2006/2007,8,6,21,15,-Inf
2005/2006,47,14,2006/2007,9,6,26,20,-Inf
2005/2006,47,15,2006/2007,10,4,21,17,-Inf
2005/2006,47,16,2006/2007,11,4,30,26,-Inf
2005/2006,47,17,2006/2007,12,8,45,37,-Inf
2005/2006,47,18,2006/2007,13,14,56,42,-Inf
2005/2006,47,19,2006/2007,14,12,75,63,-Inf
2005/2006,47,20,2006/2007,15,16,83,67,-Inf
2005/2006,47,21,2006/2007,16,10,82,72,-Inf
2005/2006,47,22,2006/2007,17,16,126,110,-Inf
2005/2006,47,23,2006/2007,18,18,119,101,-Inf
2005/2006,47,24,2006/2007,19,15,137,122,-Inf
2005/2006,47,25,2006/2007,20,23,131,108,-Inf
2005/2006,47,26,2006/2007,21,17,112,95,-Inf
2005/2006,47,27,2006/2007,22,33,82,49,-Inf
2005/2006,47,28,2006/2007,23,15,73,58,-Inf
2005/2006,47,29,2006/2007,24,13,43,30,-Inf
2005/2006,47,30,2006/2007,25,11,55,44,-Inf
2005/2006,47,31,2006/2007,26,14,55,41,-Inf
2005/2006,47,32,2006/2007,27,17,53,36,-11.512925464970229
2005/2006,47,33,2006/2007,28,19,46,27,-Inf
2005/2006,47,34,2006/2007,29,20,43,23,-Inf
2005/2006,47,35,2006/2007,30,12,29,17,-Inf
2005/2006,47,36,2006/2007,31,21,22,1,-Inf
2005/2006,47,37,2006/2007,32,7,26,19,-Inf
2005/2006,47,38,2006/2007,33,19,13,6,-Inf
2005/2006,47,39,2006/2007,34,10,17,7,-Inf
2005/2006,47,40,2006/2007,35,13,8,5,-Inf
2005/2006,47,41,2006/2007,36,10,13,3,-Inf
2005/2006,47,42,2006/2007,37,8,10,2,-Inf
2005/2006,47,43,2006/2007,38,21,17,4,-Inf
2005/2006,47,44,2006/2007,39,11,19,8,-Inf
2005/2006,47,45,2006/2007,40,9,9,0,-0.3477010443778106
2005/2006,47,46,2006/2007,41,14,9,5,-Inf
2005/2006,47,47,2006/2007,42,14,9,5,-Inf
2005/2006,47,48,2006/2007,43,15,3,12,-Inf
2005/2006,47,49,2006/2007,44,18,7,11,-Inf
2005/2006,47,50,2006/2007,45,16,7,9,-11.512925464970229
2005/2006,47,51,2006/2007,46,12,0,12,-Inf
2005/2006,47,52,2006/2007,47,20,2,18,-Inf
2005/2006,48,1,2005/2006,49,3,5,2,-Inf
2005/2006,48,2,2005/2006,50,1,7,6,-Inf
2005/2006,48,3,2005/2006,51,3,1,2,-Inf
2005/2006,48,4,2005/2006,52,3,1,2,-Inf
2005/2006,48,5,2006/2007,1,3,4,1,-10.819778284410283
2005/2006,48,6,2006/2007,2,7,2,5,-Inf
2005/2006,48,7,2006/2007,3,3,6,3,-Inf
2005/2006,48,8,2006/2007,4,5,3,2,-Inf
2005/2006,48,9,2006/2007,5,11,4,7,-Inf
2005/2006,48,10,2006/2007,6,5,10,5,-Inf
2005/2006,48,11,2006/2007,7,5,12,7,-Inf
2005/2006,48,12,2006/2007,8,6,21,15,-Inf
2005/2006,48,13,2006/2007,9,6,26,20,-Inf
2005/2006,48,14,2006/2007,10,4,21,17,-Inf
2005/2006,48,15,2006/2007,11,4,30,26,-Inf
2005/2006,48,16,2006/2007,12,8,45,37,-Inf
2005/2006,48,17,2006/2007,13,14,56,42,-Inf
2005/2006,48,18,2006/2007,14,12,75,63,-Inf
2005/2006,48,19,2006/2007,15,16,83,67,-Inf
2005/2006,48,20,2006/2007,16,10,82,72,-Inf
2005/2006,48,21,2006/2007,17,16,126,110,-Inf
2005/2006,48,22,2006/2007,18,18,119,101,-Inf
2005/2006,48,23,2006/2007,19,15,137,122,-Inf
2005/2006,48,24,2006/2007,20,23,131,108,-Inf
2005/2006,48,25,2006/2007,21,17,112,95,-Inf
2005/2006,48,26,2006/2007,22,33,82,49,-Inf
2005/2006,48,27,2006/2007,23,15,73,58,-Inf
2005/2006,48,28,2006/2007,24,13,43,30,-Inf
2005/2006,48,29,2006/2007,25,11,55,44,-Inf
2005/2006,48,30,2006/2007,26,14,55,41,-Inf
2005/2006,48,31,2006/2007,27,17,53,36,-Inf
2005/2006,48,32,2006/2007,28,19,46,27,-Inf
2005/2006,48,33,2006/2007,29,20,43,23,-Inf
2005/2006,48,34,2006/2007,30,12,29,17,-Inf
2005/2006,48,35,2006/2007,31,21,22,1,-11.512925464970229
2005/2006,48,36,2006/2007,32,7,26,19,-Inf
2005/2006,48,37,2006/2007,33,19,13,6,-Inf
2005/2006,48,38,2006/2007,34,10,17,7,-Inf
2005/2006,48,39,2006/2007,35,13,8,5,-Inf
2005/2006,48,40,2006/2007,36,10,13,3,-Inf
2005/2006,48,41,2006/2007,37,8,10,2,-Inf
2005/2006,48,42,2006/2007,38,21,17,4,-11.512925464970229
2005/2006,48,43,2006/2007,39,11,19,8,-Inf
2005/2006,48,44,2006/2007,40,9,9,0,-0.3501108207260959
2005/2006,48,45,2006/2007,41,14,9,5,-Inf
2005/2006,48,46,2006/2007,42,14,9,5,-11.512925464970229
2005/2006,48,47,2006/2007,43,15,3,12,-Inf
2005/2006,48,48,2006/2007,44,18,7,11,-Inf
2005/2006,48,49,2006/2007,45,16,7,9,-Inf
2005/2006,48,50,2006/2007,46,12,0,12,-Inf
2005/2006,48,51,2006/2007,47,20,2,18,-Inf
2005/2006,48,52,2006/2007,48,8,3,5,-11.512925464970229
2005/2006,49,1,2005/2006,50,1,7,6,-Inf
2005/2006,49,2,2005/2006,51,3,1,2,-Inf
2005/2006,49,3,2005/2006,52,3,1,2,-Inf
2005/2006,49,4,2006/2007,1,3,4,1,-9.903487552536129
2005/2006,49,5,2006/2007,2,7,2,5,-Inf
2005/2006,49,6,2006/2007,3,3,6,3,-11.512925464970229
2005/2006,49,7,2006/2007,4,5,3,2,-Inf
2005/2006,49,8,2006/2007,5,11,4,7,-Inf
2005/2006,49,9,2006/2007,6,5,10,5,-11.512925464970229
2005/2006,49,10,2006/2007,7,5,12,7,-10.819778284410283
2005/2006,49,11,2006/2007,8,6,21,15,-Inf
2005/2006,49,12,2006/2007,9,6,26,20,-Inf
2005/2006,49,13,2006/2007,10,4,21,17,-Inf
2005/2006,49,14,2006/2007,11,4,30,26,-Inf
2005/2006,49,15,2006/2007,12,8,45,37,-Inf
2005/2006,49,16,2006/2007,13,14,56,42,-Inf
2005/2006,49,17,2006/2007,14,12,75,63,-Inf
2005/2006,49,18,2006/2007,15,16,83,67,-Inf
2005/2006,49,19,2006/2007,16,10,82,72,-Inf
2005/2006,49,20,2006/2007,17,16,126,110,-Inf
2005/2006,49,21,2006/2007,18,18,119,101,-Inf
2005/2006,49,22,2006/2007,19,15,137,122,-Inf
2005/2006,49,23,2006/2007,20,23,131,108,-Inf
2005/2006,49,24,2006/2007,21,17,112,95,-Inf
2005/2006,49,25,2006/2007,22,33,82,49,-Inf
2005/2006,49,26,2006/2007,23,15,73,58,-Inf
2005/2006,49,27,2006/2007,24,13,43,30,-Inf
2005/2006,49,28,2006/2007,25,11,55,44,-Inf
2005/2006,49,29,2006/2007,26,14,55,41,-11.512925464970229
2005/2006,49,30,2006/2007,27,17,53,36,-Inf
2005/2006,49,31,2006/2007,28,19,46,27,-Inf
2005/2006,49,32,2006/2007,29,20,43,23,-Inf
2005/2006,49,33,2006/2007,30,12,29,17,-Inf
2005/2006,49,34,2006/2007,31,21,22,1,-10.819778284410283
2005/2006,49,35,2006/2007,32,7,26,19,-11.512925464970229
2005/2006,49,36,2006/2007,33,19,13,6,-Inf
2005/2006,49,37,2006/2007,34,10,17,7,-Inf
2005/2006,49,38,2006/2007,35,13,8,5,-Inf
2005/2006,49,39,2006/2007,36,10,13,3,-Inf
2005/2006,49,40,2006/2007,37,8,10,2,-11.512925464970229
2005/2006,49,41,2006/2007,38,21,17,4,-Inf
2005/2006,49,42,2006/2007,39,11,19,8,-Inf
2005/2006,49,43,2006/2007,40,9,9,0,-0.34981282791828683
2005/2006,49,44,2006/2007,41,14,9,5,-Inf
2005/2006,49,45,2006/2007,42,14,9,5,-Inf
2005/2006,49,46,2006/2007,43,15,3,12,-Inf
2005/2006,49,47,2006/2007,44,18,7,11,-Inf
2005/2006,49,48,2006/2007,45,16,7,9,-Inf
2005/2006,49,49,2006/2007,46,12,0,12,-Inf
2005/2006,49,50,2006/2007,47,20,2,18,-Inf
2005/2006,49,51,2006/2007,48,8,3,5,-Inf
2005/2006,49,52,2006/2007,49,3,3,0,-0.3504798872758208
2005/2006,4,1,2005/2006,5,4,12,8,-Inf
2005/2006,4,2,2005/2006,6,10,13,3,-11.512925464970229
2005/2006,4,3,2005/2006,7,12,10,2,-Inf
2005/2006,4,4,2005/2006,8,21,13,8,-Inf
2005/2006,4,5,2005/2006,9,26,13,13,-Inf
2005/2006,4,6,2005/2006,10,21,8,13,-Inf
2005/2006,4,7,2005/2006,11,30,21,9,-Inf
2005/2006,4,8,2005/2006,12,45,18,27,-Inf
2005/2006,4,9,2005/2006,13,56,8,48,-Inf
2005/2006,4,10,2005/2006,14,75,7,68,-Inf
2005/2006,4,11,2005/2006,15,83,20,63,-Inf
2005/2006,4,12,2005/2006,16,82,14,68,-Inf
2005/2006,4,13,2005/2006,17,126,14,112,-Inf
2005/2006,4,14,2005/2006,18,119,7,112,-Inf
2005/2006,4,15,2005/2006,19,137,14,123,-Inf
2005/2006,4,16,2005/2006,20,131,10,121,-Inf
2005/2006,4,17,2005/2006,21,112,13,99,-Inf
2005/2006,4,18,2005/2006,22,82,27,55,-Inf
2005/2006,4,19,2005/2006,23,73,13,60,-Inf
2005/2006,4,20,2005/2006,24,43,18,25,-Inf
2005/2006,4,21,2005/2006,25,55,16,39,-Inf
2005/2006,4,22,2005/2006,26,55,16,39,-Inf
2005/2006,4,23,2005/2006,27,53,20,33,-Inf
2005/2006,4,24,2005/2006,28,46,17,29,-Inf
2005/2006,4,25,2005/2006,29,43,4,39,-Inf
2005/2006,4,26,2005/2006,30,29,15,14,-Inf
2005/2006,4,27,2005/2006,31,22,8,14,-Inf
2005/2006,4,28,2005/2006,32,26,6,20,-Inf
2005/2006,4,29,2005/2006,33,13,12,1,-11.512925464970229
2005/2006,4,30,2005/2006,34,17,15,2,-Inf
2005/2006,4,31,2005/2006,35,8,11,3,-11.512925464970229
2005/2006,4,32,2005/2006,36,13,10,3,-Inf
2005/2006,4,33,2005/2006,37,10,15,5,-Inf
2005/2006,4,34,2005/2006,38,17,17,0,-0.3253700941103208
2005/2006,4,35,2005/2006,39,19,7,12,-Inf
2005/2006,4,36,2005/2006,40,9,7,2,-11.512925464970229
2005/2006,4,37,2005/2006,41,9,8,1,-11.512925464970229
2005/2006,4,38,2005/2006,42,9,9,0,-0.3282679837307665
2005/2006,4,39,2005/2006,43,3,12,9,-Inf
2005/2006,4,40,2005/2006,44,7,12,5,-11.512925464970229
2005/2006,4,41,2005/2006,45,7,5,2,-Inf
2005/2006,4,42,2005/2006,46,0,4,4,-Inf
2005/2006,4,43,2005/2006,47,2,11,9,-Inf
2005/2006,4,44,2005/2006,48,3,4,1,-10.819778284410283
2005/2006,4,45,2005/2006,49,3,5,2,-10.819778284410283
2005/2006,4,46,2005/2006,50,1,7,6,-Inf
2005/2006,4,47,2005/2006,51,3,1,2,-Inf
2005/2006,4,48,2005/2006,52,3,1,2,-Inf
2005/2006,4,49,2006/2007,1,3,4,1,-11.512925464970229
2005/2006,4,50,2006/2007,2,7,2,5,-11.512925464970229
2005/2006,4,51,2006/2007,3,3,6,3,-Inf
2005/2006,4,52,2006/2007,4,5,3,2,-Inf
2005/2006,50,1,2005/2006,51,3,1,2,-Inf
2005/2006,50,2,2005/2006,52,3,1,2,-Inf
2005/2006,50,3,2006/2007,1,3,4,1,-10.819778284410283
2005/2006,50,4,2006/2007,2,7,2,5,-Inf
2005/2006,50,5,2006/2007,3,3,6,3,-Inf
2005/2006,50,6,2006/2007,4,5,3,2,-Inf
2005/2006,50,7,2006/2007,5,11,4,7,-Inf
2005/2006,50,8,2006/2007,6,5,10,5,-Inf
2005/2006,50,9,2006/2007,7,5,12,7,-Inf
2005/2006,50,10,2006/2007,8,6,21,15,-Inf
2005/2006,50,11,2006/2007,9,6,26,20,-Inf
2005/2006,50,12,2006/2007,10,4,21,17,-Inf
2005/2006,50,13,2006/2007,11,4,30,26,-Inf
2005/2006,50,14,2006/2007,12,8,45,37,-Inf
2005/2006,50,15,2006/2007,13,14,56,42,-Inf
2005/2006,50,16,2006/2007,14,12,75,63,-Inf
2005/2006,50,17,2006/2007,15,16,83,67,-Inf
2005/2006,50,18,2006/2007,16,10,82,72,-Inf
2005/2006,50,19,2006/2007,17,16,126,110,-Inf
2005/2006,50,20,2006/2007,18,18,119,101,-Inf
2005/2006,50,21,2006/2007,19,15,137,122,-Inf
2005/2006,50,22,2006/2007,20,23,131,108,-Inf
2005/2006,50,23,2006/2007,21,17,112,95,-Inf
2005/2006,50,24,2006/2007,22,33,82,49,-Inf
2005/2006,50,25,2006/2007,23,15,73,58,-Inf
2005/2006,50,26,2006/2007,24,13,43,30,-Inf
2005/2006,50,27,2006/2007,25,11,55,44,-Inf
2005/2006,50,28,2006/2007,26,14,55,41,-Inf
2005/2006,50,29,2006/2007,27,17,53,36,-Inf
2005/2006,50,30,2006/2007,28,19,46,27,-Inf
2005/2006,50,31,2006/2007,29,20,43,23,-Inf
2005/2006,50,32,2006/2007,30,12,29,17,-Inf
2005/2006,50,33,2006/2007,31,21,22,1,-11.512925464970229
2005/2006,50,34,2006/2007,32,7,26,19,-Inf
2005/2006,50,35,2006/2007,33,19,13,6,-Inf
2005/2006,50,36,2006/2007,34,10,17,7,-11.512925464970229
2005/2006,50,37,2006/2007,35,13,8,5,-Inf
2005/2006,50,38,2006/2007,36,10,13,3,-Inf
2005/2006,50,39,2006/2007,37,8,10,2,-Inf
2005/2006,50,40,2006/2007,38,21,17,4,-11.512925464970229
2005/2006,50,41,2006/2007,39,11,19,8,-Inf
2005/2006,50,42,2006/2007,40,9,9,0,-0.35907782855504244
2005/2006,50,43,2006/2007,41,14,9,5,-Inf
2005/2006,50,44,2006/2007,42,14,9,5,-Inf
2005/2006,50,45,2006/2007,43,15,3,12,-Inf
2005/2006,50,46,2006/2007,44,18,7,11,-Inf
2005/2006,50,47,2006/2007,45,16,7,9,-11.512925464970229
2005/2006,50,48,2006/2007,46,12,0,12,-Inf
2005/2006,50,49,2006/2007,47,20,2,18,-Inf
2005/2006,50,50,2006/2007,48,8,3,5,-11.512925464970229
2005/2006,50,51,2006/2007,49,3,3,0,-0.355661172264643
2005/2006,50,52,2006/2007,50,13,1,12,-Inf
2005/2006,51,1,2005/2006,52,3,1,2,-Inf
2005/2006,51,2,2006/2007,1,3,4,1,-11.512925464970229
2005/2006,51,3,2006/2007,2,7,2,5,-Inf
2005/2006,51,4,2006/2007,3,3,6,3,-Inf
2005/2006,51,5,2006/2007,4,5,3,2,-Inf
2005/2006,51,6,2006/2007,5,11,4,7,-Inf
2005/2006,51,7,2006/2007,6,5,10,5,-Inf
2005/2006,51,8,2006/2007,7,5,12,7,-Inf
2005/2006,51,9,2006/2007,8,6,21,15,-Inf
2005/2006,51,10,2006/2007,9,6,26,20,-Inf
2005/2006,51,11,2006/2007,10,4,21,17,-Inf
2005/2006,51,12,2006/2007,11,4,30,26,-Inf
2005/2006,51,13,2006/2007,12,8,45,37,-Inf
2005/2006,51,14,2006/2007,13,14,56,42,-Inf
2005/2006,51,15,2006/2007,14,12,75,63,-Inf
2005/2006,51,16,2006/2007,15,16,83,67,-Inf
2005/2006,51,17,2006/2007,16,10,82,72,-Inf
2005/2006,51,18,2006/2007,17,16,126,110,-Inf
2005/2006,51,19,2006/2007,18,18,119,101,-Inf
2005/2006,51,20,2006/2007,19,15,137,122,-Inf
2005/2006,51,21,2006/2007,20,23,131,108,-Inf
2005/2006,51,22,2006/2007,21,17,112,95,-Inf
2005/2006,51,23,2006/2007,22,33,82,49,-11.512925464970229
2005/2006,51,24,2006/2007,23,15,73,58,-Inf
2005/2006,51,25,2006/2007,24,13,43,30,-Inf
2005/2006,51,26,2006/2007,25,11,55,44,-Inf
2005/2006,51,27,2006/2007,26,14,55,41,-Inf
2005/2006,51,28,2006/2007,27,17,53,36,-Inf
2005/2006,51,29,2006/2007,28,19,46,27,-Inf
2005/2006,51,30,2006/2007,29,20,43,23,-Inf
2005/2006,51,31,2006/2007,30,12,29,17,-Inf
2005/2006,51,32,2006/2007,31,21,22,1,-10.819778284410283
2005/2006,51,33,2006/2007,32,7,26,19,-Inf
2005/2006,51,34,2006/2007,33,19,13,6,-Inf
2005/2006,51,35,2006/2007,34,10,17,7,-Inf
2005/2006,51,36,2006/2007,35,13,8,5,-Inf
2005/2006,51,37,2006/2007,36,10,13,3,-Inf
2005/2006,51,38,2006/2007,37,8,10,2,-Inf
2005/2006,51,39,2006/2007,38,21,17,4,-11.512925464970229
2005/2006,51,40,2006/2007,39,11,19,8,-Inf
2005/2006,51,41,2006/2007,40,9,9,0,-0.3360883103303447
2005/2006,51,42,2006/2007,41,14,9,5,-Inf
2005/2006,51,43,2006/2007,42,14,9,5,-Inf
2005/2006,51,44,2006/2007,43,15,3,12,-Inf
2005/2006,51,45,2006/2007,44,18,7,11,-Inf
2005/2006,51,46,2006/2007,45,16,7,9,-11.512925464970229
2005/2006,51,47,2006/2007,46,12,0,12,-Inf
2005/2006,51,48,2006/2007,47,20,2,18,-Inf
2005/2006,51,49,2006/2007,48,8,3,5,-Inf
2005/2006,51,50,2006/2007,49,3,3,0,-0.3445487641408924
2005/2006,51,51,2006/2007,50,13,1,12,-11.512925464970229
2005/2006,51,52,2006/2007,51,4,3,1,-10.819778284410283
2005/2006,52,1,2006/2007,1,3,4,1,-Inf
2005/2006,52,2,2006/2007,2,7,2,5,-Inf
2005/2006,52,3,2006/2007,3,3,6,3,-Inf
2005/2006,52,4,2006/2007,4,5,3,2,-11.512925464970229
2005/2006,52,5,2006/2007,5,11,4,7,-Inf
2005/2006,52,6,2006/2007,6,5,10,5,-11.512925464970229
2005/2006,52,7,2006/2007,7,5,12,7,-Inf
2005/2006,52,8,2006/2007,8,6,21,15,-Inf
2005/2006,52,9,2006/2007,9,6,26,20,-Inf
2005/2006,52,10,2006/2007,10,4,21,17,-Inf
2005/2006,52,11,2006/2007,11,4,30,26,-Inf
2005/2006,52,12,2006/2007,12,8,45,37,-Inf
2005/2006,52,13,2006/2007,13,14,56,42,-Inf
2005/2006,52,14,2006/2007,14,12,75,63,-Inf
2005/2006,52,15,2006/2007,15,16,83,67,-Inf
2005/2006,52,16,2006/2007,16,10,82,72,-Inf
2005/2006,52,17,2006/2007,17,16,126,110,-Inf
2005/2006,52,18,2006/2007,18,18,119,101,-Inf
2005/2006,52,19,2006/2007,19,15,137,122,-Inf
2005/2006,52,20,2006/2007,20,23,131,108,-Inf
2005/2006,52,21,2006/2007,21,17,112,95,-Inf
2005/2006,52,22,2006/2007,22,33,82,49,-Inf
2005/2006,52,23,2006/2007,23,15,73,58,-Inf
2005/2006,52,24,2006/2007,24,13,43,30,-Inf
2005/2006,52,25,2006/2007,25,11,55,44,-Inf
2005/2006,52,26,2006/2007,26,14,55,41,-Inf
2005/2006,52,27,2006/2007,27,17,53,36,-Inf
2005/2006,52,28,2006/2007,28,19,46,27,-Inf
2005/2006,52,29,2006/2007,29,20,43,23,-Inf
2005/2006,52,30,2006/2007,30,12,29,17,-Inf
2005/2006,52,31,2006/2007,31,21,22,1,-10.819778284410283
2005/2006,52,32,2006/2007,32,7,26,19,-Inf
2005/2006,52,33,2006/2007,33,19,13,6,-11.512925464970229
2005/2006,52,34,2006/2007,34,10,17,7,-Inf
2005/2006,52,35,2006/2007,35,13,8,5,-Inf
2005/2006,52,36,2006/2007,36,10,13,3,-11.512925464970229
2005/2006,52,37,2006/2007,37,8,10,2,-11.512925464970229
2005/2006,52,38,2006/2007,38,21,17,4,-Inf
2005/2006,52,39,2006/2007,39,11,19,8,-Inf
2005/2006,52,40,2006/2007,40,9,9,0,-0.3331677026129132
2005/2006,52,41,2006/2007,41,14,9,5,-Inf
2005/2006,52,42,2006/2007,42,14,9,5,-Inf
2005/2006,52,43,2006/2007,43,15,3,12,-Inf
2005/2006,52,44,2006/2007,44,18,7,11,-Inf
2005/2006,52,45,2006/2007,45,16,7,9,-Inf
2005/2006,52,46,2006/2007,46,12,0,12,-Inf
2005/2006,52,47,2006/2007,47,20,2,18,-Inf
2005/2006,52,48,2006/2007,48,8,3,5,-Inf
2005/2006,52,49,2006/2007,49,3,3,0,-0.34015500971289825
2005/2006,52,50,2006/2007,50,13,1,12,-Inf
2005/2006,52,51,2006/2007,51,4,3,1,-11.512925464970229
2005/2006,52,52,2006/2007,52,1,3,2,-Inf
2005/2006,5,1,2005/2006,6,10,13,3,-10.819778284410283
2005/2006,5,2,2005/2006,7,12,10,2,-Inf
2005/2006,5,3,2005/2006,8,21,13,8,-Inf
2005/2006,5,4,2005/2006,9,26,13,13,-Inf
2005/2006,5,5,2005/2006,10,21,8,13,-Inf
2005/2006,5,6,2005/2006,11,30,21,9,-Inf
2005/2006,5,7,2005/2006,12,45,18,27,-Inf
2005/2006,5,8,2005/2006,13,56,8,48,-Inf
2005/2006,5,9,2005/2006,14,75,7,68,-Inf
2005/2006,5,10,2005/2006,15,83,20,63,-Inf
2005/2006,5,11,2005/2006,16,82,14,68,-Inf
2005/2006,5,12,2005/2006,17,126,14,112,-Inf
2005/2006,5,13,2005/2006,18,119,7,112,-Inf
2005/2006,5,14,2005/2006,19,137,14,123,-Inf
2005/2006,5,15,2005/2006,20,131,10,121,-Inf
2005/2006,5,16,2005/2006,21,112,13,99,-Inf
2005/2006,5,17,2005/2006,22,82,27,55,-Inf
2005/2006,5,18,2005/2006,23,73,13,60,-Inf
2005/2006,5,19,2005/2006,24,43,18,25,-Inf
2005/2006,5,20,2005/2006,25,55,16,39,-Inf
2005/2006,5,21,2005/2006,26,55,16,39,-Inf
2005/2006,5,22,2005/2006,27,53,20,33,-Inf
2005/2006,5,23,2005/2006,28,46,17,29,-Inf
2005/2006,5,24,2005/2006,29,43,4,39,-Inf
2005/2006,5,25,2005/2006,30,29,15,14,-Inf
2005/2006,5,26,2005/2006,31,22,8,14,-Inf
2005/2006,5,27,2005/2006,32,26,6,20,-Inf
2005/2006,5,28,2005/2006,33,13,12,1,-10.819778284410283
2005/2006,5,29,2005/2006,34,17,15,2,-11.512925464970229
2005/2006,5,30,2005/2006,35,8,11,3,-Inf
2005/2006,5,31,2005/2006,36,13,10,3,-Inf
2005/2006,5,32,2005/2006,37,10,15,5,-11.512925464970229
2005/2006,5,33,2005/2006,38,17,17,0,-0.32658923476726365
2005/2006,5,34,2005/2006,39,19,7,12,-Inf
2005/2006,5,35,2005/2006,40,9,7,2,-11.512925464970229
2005/2006,5,36,2005/2006,41,9,8,1,-Inf
2005/2006,5,37,2005/2006,42,9,9,0,-0.3326236519330301
2005/2006,5,38,2005/2006,43,3,12,9,-Inf
2005/2006,5,39,2005/2006,44,7,12,5,-Inf
2005/2006,5,40,2005/2006,45,7,5,2,-Inf
2005/2006,5,41,2005/2006,46,0,4,4,-Inf
2005/2006,5,42,2005/2006,47,2,11,9,-Inf
2005/2006,5,43,2005/2006,48,3,4,1,-10.41431317630212
2005/2006,5,44,2005/2006,49,3,5,2,-Inf
2005/2006,5,45,2005/2006,50,1,7,6,-Inf
2005/2006,5,46,2005/2006,51,3,1,2,-11.512925464970229
2005/2006,5,47,2005/2006,52,3,1,2,-Inf
2005/2006,5,48,2006/2007,1,3,4,1,-11.512925464970229
2005/2006,5,49,2006/2007,2,7,2,5,-Inf
2005/2006,5,50,2006/2007,3,3,6,3,-10.819778284410283
2005/2006,5,51,2006/2007,4,5,3,2,-Inf
2005/2006,5,52,2006/2007,5,11,4,7,-11.512925464970229
2005/2006,6,1,2005/2006,7,12,10,2,-11.512925464970229
2005/2006,6,2,2005/2006,8,21,13,8,-Inf
2005/2006,6,3,2005/2006,9,26,13,13,-Inf
2005/2006,6,4,2005/2006,10,21,8,13,-Inf
2005/2006,6,5,2005/2006,11,30,21,9,-Inf
2005/2006,6,6,2005/2006,12,45,18,27,-Inf
2005/2006,6,7,2005/2006,13,56,8,48,-Inf
2005/2006,6,8,2005/2006,14,75,7,68,-Inf
2005/2006,6,9,2005/2006,15,83,20,63,-Inf
2005/2006,6,10,2005/2006,16,82,14,68,-Inf
2005/2006,6,11,2005/2006,17,126,14,112,-Inf
2005/2006,6,12,2005/2006,18,119,7,112,-Inf
2005/2006,6,13,2005/2006,19,137,14,123,-Inf
2005/2006,6,14,2005/2006,20,131,10,121,-Inf
2005/2006,6,15,2005/2006,21,112,13,99,-Inf
2005/2006,6,16,2005/2006,22,82,27,55,-Inf
2005/2006,6,17,2005/2006,23,73,13,60,-Inf
2005/2006,6,18,2005/2006,24,43,18,25,-Inf
2005/2006,6,19,2005/2006,25,55,16,39,-Inf
2005/2006,6,20,2005/2006,26,55,16,39,-Inf
2005/2006,6,21,2005/2006,27,53,20,33,-Inf
2005/2006,6,22,2005/2006,28,46,17,29,-Inf
2005/2006,6,23,2005/2006,29,43,4,39,-Inf
2005/2006,6,24,2005/2006,30,29,15,14,-Inf
2005/2006,6,25,2005/2006,31,22,8,14,-Inf
2005/2006,6,26,2005/2006,32,26,6,20,-Inf
2005/2006,6,27,2005/2006,33,13,12,1,-11.512925464970229
2005/2006,6,28,2005/2006,34,17,15,2,-Inf
2005/2006,6,29,2005/2006,35,8,11,3,-Inf
2005/2006,6,30,2005/2006,36,13,10,3,-Inf
2005/2006,6,31,2005/2006,37,10,15,5,-Inf
2005/2006,6,32,2005/2006,38,17,17,0,-0.33544476465136697
2005/2006,6,33,2005/2006,39,19,7,12,-Inf
2005/2006,6,34,2005/2006,40,9,7,2,-Inf
2005/2006,6,35,2005/2006,41,9,8,1,-Inf
2005/2006,6,36,2005/2006,42,9,9,0,-0.3393122656886405
2005/2006,6,37,2005/2006,43,3,12,9,-Inf
2005/2006,6,38,2005/2006,44,7,12,5,-Inf
2005/2006,6,39,2005/2006,45,7,5,2,-Inf
2005/2006,6,40,2005/2006,46,0,4,4,-Inf
2005/2006,6,41,2005/2006,47,2,11,9,-11.512925464970229
2005/2006,6,42,2005/2006,48,3,4,1,-10.41431317630212
2005/2006,6,43,2005/2006,49,3,5,2,-Inf
2005/2006,6,44,2005/2006,50,1,7,6,-11.512925464970229
2005/2006,6,45,2005/2006,51,3,1,2,-11.512925464970229
2005/2006,6,46,2005/2006,52,3,1,2,-Inf
2005/2006,6,47,2006/2007,1,3,4,1,-11.512925464970229
2005/2006,6,48,2006/2007,2,7,2,5,-Inf
2005/2006,6,49,2006/2007,3,3,6,3,-Inf
2005/2006,6,50,2006/2007,4,5,3,2,-Inf
2005/2006,6,51,2006/2007,5,11,4,7,-Inf
2005/2006,6,52,2006/2007,6,5,10,5,-Inf
2005/2006,7,1,2005/2006,8,21,13,8,-Inf
2005/2006,7,2,2005/2006,9,26,13,13,-Inf
2005/2006,7,3,2005/2006,10,21,8,13,-Inf
2005/2006,7,4,2005/2006,11,30,21,9,-Inf
2005/2006,7,5,2005/2006,12,45,18,27,-Inf
2005/2006,7,6,2005/2006,13,56,8,48,-Inf
2005/2006,7,7,2005/2006,14,75,7,68,-Inf
2005/2006,7,8,2005/2006,15,83,20,63,-Inf
2005/2006,7,9,2005/2006,16,82,14,68,-Inf
2005/2006,7,10,2005/2006,17,126,14,112,-Inf
2005/2006,7,11,2005/2006,18,119,7,112,-Inf
2005/2006,7,12,2005/2006,19,137,14,123,-Inf
2005/2006,7,13,2005/2006,20,131,10,121,-Inf
2005/2006,7,14,2005/2006,21,112,13,99,-Inf
2005/2006,7,15,2005/2006,22,82,27,55,-Inf
2005/2006,7,16,2005/2006,23,73,13,60,-Inf
2005/2006,7,17,2005/2006,24,43,18,25,-Inf
2005/2006,7,18,2005/2006,25,55,16,39,-Inf
2005/2006,7,19,2005/2006,26,55,16,39,-Inf
2005/2006,7,20,2005/2006,27,53,20,33,-Inf
2005/2006,7,21,2005/2006,28,46,17,29,-Inf
2005/2006,7,22,2005/2006,29,43,4,39,-Inf
2005/2006,7,23,2005/2006,30,29,15,14,-Inf
2005/2006,7,24,2005/2006,31,22,8,14,-Inf
2005/2006,7,25,2005/2006,32,26,6,20,-Inf
2005/2006,7,26,2005/2006,33,13,12,1,-Inf
2005/2006,7,27,2005/2006,34,17,15,2,-Inf
2005/2006,7,28,2005/2006,35,8,11,3,-Inf
2005/2006,7,29,2005/2006,36,13,10,3,-Inf
2005/2006,7,30,2005/2006,37,10,15,5,-Inf
2005/2006,7,31,2005/2006,38,17,17,0,-0.3168225621981975
2005/2006,7,32,2005/2006,39,19,7,12,-Inf
2005/2006,7,33,2005/2006,40,9,7,2,-Inf
2005/2006,7,34,2005/2006,41,9,8,1,-Inf
2005/2006,7,35,2005/2006,42,9,9,0,-0.3212940108970095
2005/2006,7,36,2005/2006,43,3,12,9,-Inf
2005/2006,7,37,2005/2006,44,7,12,5,-Inf
2005/2006,7,38,2005/2006,45,7,5,2,-11.512925464970229
2005/2006,7,39,2005/2006,46,0,4,4,-11.512925464970229
2005/2006,7,40,2005/2006,47,2,11,9,-Inf
2005/2006,7,41,2005/2006,48,3,4,1,-11.512925464970229
2005/2006,7,42,2005/2006,49,3,5,2,-Inf
2005/2006,7,43,2005/2006,50,1,7,6,-Inf
2005/2006,7,44,2005/2006,51,3,1,2,-11.512925464970229
2005/2006,7,45,2005/2006,52,3,1,2,-Inf
2005/2006,7,46,2006/2007,1,3,4,1,-11.512925464970229
2005/2006,7,47,2006/2007,2,7,2,5,-Inf
2005/2006,7,48,2006/2007,3,3,6,3,-11.512925464970229
2005/2006,7,49,2006/2007,4,5,3,2,-11.512925464970229
2005/2006,7,50,2006/2007,5,11,4,7,-Inf
2005/2006,7,51,2006/2007,6,5,10,5,-Inf
2005/2006,7,52,2006/2007,7,5,12,7,-Inf
2005/2006,8,1,2005/2006,9,26,13,13,-Inf
2005/2006,8,2,2005/2006,10,21,8,13,-Inf
2005/2006,8,3,2005/2006,11,30,21,9,-Inf
2005/2006,8,4,2005/2006,12,45,18,27,-Inf
2005/2006,8,5,2005/2006,13,56,8,48,-11.512925464970229
2005/2006,8,6,2005/2006,14,75,7,68,-Inf
2005/2006,8,7,2005/2006,15,83,20,63,-Inf
2005/2006,8,8,2005/2006,16,82,14,68,-Inf
2005/2006,8,9,2005/2006,17,126,14,112,-Inf
2005/2006,8,10,2005/2006,18,119,7,112,-Inf
2005/2006,8,11,2005/2006,19,137,14,123,-Inf
2005/2006,8,12,2005/2006,20,131,10,121,-Inf
2005/2006,8,13,2005/2006,21,112,13,99,-Inf
2005/2006,8,14,2005/2006,22,82,27,55,-Inf
2005/2006,8,15,2005/2006,23,73,13,60,-Inf
2005/2006,8,16,2005/2006,24,43,18,25,-Inf
2005/2006,8,17,2005/2006,25,55,16,39,-Inf
2005/2006,8,18,2005/2006,26,55,16,39,-Inf
2005/2006,8,19,2005/2006,27,53,20,33,-Inf
2005/2006,8,20,2005/2006,28,46,17,29,-Inf
2005/2006,8,21,2005/2006,29,43,4,39,-Inf
2005/2006,8,22,2005/2006,30,29,15,14,-Inf
2005/2006,8,23,2005/2006,31,22,8,14,-Inf
2005/2006,8,24,2005/2006,32,26,6,20,-Inf
2005/2006,8,25,2005/2006,33,13,12,1,-Inf
2005/2006,8,26,2005/2006,34,17,15,2,-Inf
2005/2006,8,27,2005/2006,35,8,11,3,-11.512925464970229
2005/2006,8,28,2005/2006,36,13,10,3,-11.512925464970229
2005/2006,8,29,2005/2006,37,10,15,5,-Inf
2005/2006,8,30,2005/2006,38,17,17,0,-0.32050834038333065
2005/2006,8,31,2005/2006,39,19,7,12,-Inf
2005/2006,8,32,2005/2006,40,9,7,2,-11.512925464970229
2005/2006,8,33,2005/2006,41,9,8,1,-11.512925464970229
2005/2006,8,34,2005/2006,42,9,9,0,-0.3262150221685651
2005/2006,8,35,2005/2006,43,3,12,9,-Inf
2005/2006,8,36,2005/2006,44,7,12,5,-Inf
2005/2006,8,37,2005/2006,45,7,5,2,-11.512925464970229
2005/2006,8,38,2005/2006,46,0,4,4,-10.819778284410283
2005/2006,8,39,2005/2006,47,2,11,9,-Inf
2005/2006,8,40,2005/2006,48,3,4,1,-11.512925464970229
2005/2006,8,41,2005/2006,49,3,5,2,-Inf
2005/2006,8,42,2005/2006,50,1,7,6,-Inf
2005/2006,8,43,2005/2006,51,3,1,2,-10.819778284410283
2005/2006,8,44,2005/2006,52,3,1,2,-10.819778284410283
2005/2006,8,45,2006/2007,1,3,4,1,-10.819778284410283
2005/2006,8,46,2006/2007,2,7,2,5,-11.512925464970229
2005/2006,8,47,2006/2007,3,3,6,3,-Inf
2005/2006,8,48,2006/2007,4,5,3,2,-Inf
2005/2006,8,49,2006/2007,5,11,4,7,-Inf
2005/2006,8,50,2006/2007,6,5,10,5,-Inf
2005/2006,8,51,2006/2007,7,5,12,7,-Inf
2005/2006,8,52,2006/2007,8,6,21,15,-11.512925464970229
2005/2006,9,1,2005/2006,10,21,8,13,-Inf
2005/2006,9,2,2005/2006,11,30,21,9,-Inf
2005/2006,9,3,2005/2006,12,45,18,27,-Inf
2005/2006,9,4,2005/2006,13,56,8,48,-Inf
2005/2006,9,5,2005/2006,14,75,7,68,-Inf
2005/2006,9,6,2005/2006,15,83,20,63,-Inf
2005/2006,9,7,2005/2006,16,82,14,68,-Inf
2005/2006,9,8,2005/2006,17,126,14,112,-Inf
2005/2006,9,9,2005/2006,18,119,7,112,-Inf
2005/2006,9,10,2005/2006,19,137,14,123,-Inf
2005/2006,9,11,2005/2006,20,131,10,121,-Inf
2005/2006,9,12,2005/2006,21,112,13,99,-Inf
2005/2006,9,13,2005/2006,22,82,27,55,-Inf
2005/2006,9,14,2005/2006,23,73,13,60,-Inf
2005/2006,9,15,2005/2006,24,43,18,25,-Inf
2005/2006,9,16,2005/2006,25,55,16,39,-Inf
2005/2006,9,17,2005/2006,26,55,16,39,-Inf
2005/2006,9,18,2005/2006,27,53,20,33,-Inf
2005/2006,9,19,2005/2006,28,46,17,29,-11.512925464970229
2005/2006,9,20,2005/2006,29,43,4,39,-Inf
2005/2006,9,21,2005/2006,30,29,15,14,-Inf
2005/2006,9,22,2005/2006,31,22,8,14,-Inf
2005/2006,9,23,2005/2006,32,26,6,20,-Inf
2005/2006,9,24,2005/2006,33,13,12,1,-Inf
2005/2006,9,25,2005/2006,34,17,15,2,-11.512925464970229
2005/2006,9,26,2005/2006,35,8,11,3,-Inf
2005/2006,9,27,2005/2006,36,13,10,3,-Inf
2005/2006,9,28,2005/2006,37,10,15,5,-Inf
2005/2006,9,29,2005/2006,38,17,17,0,-0.33201020630132305
2005/2006,9,30,2005/2006,39,19,7,12,-Inf
2005/2006,9,31,2005/2006,40,9,7,2,-Inf
2005/2006,9,32,2005/2006,41,9,8,1,-10.41431317630212
2005/2006,9,33,2005/2006,42,9,9,0,-0.3358224477797158
2005/2006,9,34,2005/2006,43,3,12,9,-Inf
2005/2006,9,35,2005/2006,44,7,12,5,-Inf
2005/2006,9,36,2005/2006,45,7,5,2,-11.512925464970229
2005/2006,9,37,2005/2006,46,0,4,4,-Inf
2005/2006,9,38,2005/2006,47,2,11,9,-Inf
2005/2006,9,39,2005/2006,48,3,4,1,-11.512925464970229
2005/2006,9,40,2005/2006,49,3,5,2,-10.819778284410283
2005/2006,9,41,2005/2006,50,1,7,6,-Inf
2005/2006,9,42,2005/2006,51,3,1,2,-11.512925464970229
2005/2006,9,43,2005/2006,52,3,1,2,-Inf
2005/2006,9,44,2006/2007,1,3,4,1,-11.512925464970229
2005/2006,9,45,2006/2007,2,7,2,5,-Inf
2005/2006,9,46,2006/2007,3,3,6,3,-Inf
2005/2006,9,47,2006/2007,4,5,3,2,-Inf
2005/2006,9,48,2006/2007,5,11,4,7,-Inf
2005/2006,9,49,2006/2007,6,5,10,5,-11.512925464970229
2005/2006,9,50,2006/2007,7,5,12,7,-Inf
2005/2006,9,51,2006/2007,8,6,21,15,-Inf
2005/2006,9,52,2006/2007,9,6,26,20,-Inf
2006/2007,10,1,2006/2007,11,4,30,26,-Inf
2006/2007,10,2,2006/2007,12,8,45,37,-Inf
2006/2007,10,3,2006/2007,13,14,56,42,-Inf
2006/2007,10,4,2006/2007,14,12,75,63,-Inf
2006/2007,10,5,2006/2007,15,16,83,67,-Inf
2006/2007,10,6,2006/2007,16,10,82,72,-Inf
2006/2007,10,7,2006/2007,17,16,126,110,-Inf
2006/2007,10,8,2006/2007,18,18,119,101,-Inf
2006/2007,10,9,2006/2007,19,15,137,122,-Inf
2006/2007,10,10,2006/2007,20,23,131,108,-Inf
2006/2007,10,11,2006/2007,21,17,112,95,-Inf
2006/2007,10,12,2006/2007,22,33,82,49,-Inf
2006/2007,10,13,2006/2007,23,15,73,58,-Inf
2006/2007,10,14,2006/2007,24,13,43,30,-Inf
2006/2007,10,15,2006/2007,25,11,55,44,-Inf
2006/2007,10,16,2006/2007,26,14,55,41,-Inf
2006/2007,10,17,2006/2007,27,17,53,36,-Inf
2006/2007,10,18,2006/2007,28,19,46,27,-Inf
2006/2007,10,19,2006/2007,29,20,43,23,-Inf
2006/2007,10,20,2006/2007,30,12,29,17,-Inf
2006/2007,10,21,2006/2007,31,21,22,1,-10.819778284410283
2006/2007,10,22,2006/2007,32,7,26,19,-Inf
2006/2007,10,23,2006/2007,33,19,13,6,-Inf
2006/2007,10,24,2006/2007,34,10,17,7,-11.512925464970229
2006/2007,10,25,2006/2007,35,13,8,5,-Inf
2006/2007,10,26,2006/2007,36,10,13,3,-11.512925464970229
2006/2007,10,27,2006/2007,37,8,10,2,-Inf
2006/2007,10,28,2006/2007,38,21,17,4,-Inf
2006/2007,10,29,2006/2007,39,11,19,8,-11.512925464970229
2006/2007,10,30,2006/2007,40,9,9,0,-0.368747525173001
2006/2007,10,31,2006/2007,41,14,9,5,-Inf
2006/2007,10,32,2006/2007,42,14,9,5,-Inf
2006/2007,10,33,2006/2007,43,15,3,12,-Inf
2006/2007,10,34,2006/2007,44,18,7,11,-Inf
2006/2007,10,35,2006/2007,45,16,7,9,-Inf
2006/2007,10,36,2006/2007,46,12,0,12,-Inf
2006/2007,10,37,2006/2007,47,20,2,18,-Inf
2006/2007,10,38,2006/2007,48,8,3,5,-Inf
2006/2007,10,39,2006/2007,49,3,3,0,-0.35841932162408163
2006/2007,10,40,2006/2007,50,13,1,12,-Inf
2006/2007,10,41,2006/2007,51,4,3,1,-11.512925464970229
2006/2007,10,42,2006/2007,52,1,3,2,-10.819778284410283
2006/2007,10,43,2007/2008,1,10,3,7,-Inf
2006/2007,10,44,2007/2008,2,8,7,1,-11.512925464970229
2006/2007,10,45,2007/2008,3,13,3,10,-Inf
2006/2007,10,46,2007/2008,4,10,5,5,-Inf
2006/2007,10,47,2007/2008,5,21,11,10,-Inf
2006/2007,10,48,2007/2008,6,18,5,13,-Inf
2006/2007,10,49,2007/2008,7,21,5,16,-Inf
2006/2007,10,50,2007/2008,8,34,6,28,-Inf
2006/2007,10,51,2007/2008,9,25,6,19,-Inf
2006/2007,10,52,2007/2008,10,34,4,30,-Inf
2006/2007,11,1,2006/2007,12,8,45,37,-Inf
2006/2007,11,2,2006/2007,13,14,56,42,-Inf
2006/2007,11,3,2006/2007,14,12,75,63,-Inf
2006/2007,11,4,2006/2007,15,16,83,67,-Inf
2006/2007,11,5,2006/2007,16,10,82,72,-Inf
2006/2007,11,6,2006/2007,17,16,126,110,-Inf
2006/2007,11,7,2006/2007,18,18,119,101,-Inf
2006/2007,11,8,2006/2007,19,15,137,122,-Inf
2006/2007,11,9,2006/2007,20,23,131,108,-Inf
2006/2007,11,10,2006/2007,21,17,112,95,-Inf
2006/2007,11,11,2006/2007,22,33,82,49,-Inf
2006/2007,11,12,2006/2007,23,15,73,58,-Inf
2006/2007,11,13,2006/2007,24,13,43,30,-Inf
2006/2007,11,14,2006/2007,25,11,55,44,-Inf
2006/2007,11,15,2006/2007,26,14,55,41,-Inf
2006/2007,11,16,2006/2007,27,17,53,36,-Inf
2006/2007,11,17,2006/2007,28,19,46,27,-Inf
2006/2007,11,18,2006/2007,29,20,43,23,-Inf
2006/2007,11,19,2006/2007,30,12,29,17,-Inf
2006/2007,11,20,2006/2007,31,21,22,1,-10.41431317630212
2006/2007,11,21,2006/2007,32,7,26,19,-Inf
2006/2007,11,22,2006/2007,33,19,13,6,-Inf
2006/2007,11,23,2006/2007,34,10,17,7,-Inf
2006/2007,11,24,2006/2007,35,13,8,5,-Inf
2006/2007,11,25,2006/2007,36,10,13,3,-Inf
2006/2007,11,26,2006/2007,37,8,10,2,-11.512925464970229
2006/2007,11,27,2006/2007,38,21,17,4,-Inf
2006/2007,11,28,2006/2007,39,11,19,8,-Inf
2006/2007,11,29,2006/2007,40,9,9,0,-0.3680826219208342
2006/2007,11,30,2006/2007,41,14,9,5,-Inf
2006/2007,11,31,2006/2007,42,14,9,5,-Inf
2006/2007,11,32,2006/2007,43,15,3,12,-Inf
2006/2007,11,33,2006/2007,44,18,7,11,-Inf
2006/2007,11,34,2006/2007,45,16,7,9,-Inf
2006/2007,11,35,2006/2007,46,12,0,12,-Inf
2006/2007,11,36,2006/2007,47,20,2,18,-Inf
2006/2007,11,37,2006/2007,48,8,3,5,-Inf
2006/2007,11,38,2006/2007,49,3,3,0,-0.3587485208856407
2006/2007,11,39,2006/2007,50,13,1,12,-Inf
2006/2007,11,40,2006/2007,51,4,3,1,-10.819778284410283
2006/2007,11,41,2006/2007,52,1,3,2,-Inf
2006/2007,11,42,2007/2008,1,10,3,7,-11.512925464970229
2006/2007,11,43,2007/2008,2,8,7,1,-10.819778284410283
2006/2007,11,44,2007/2008,3,13,3,10,-Inf
2006/2007,11,45,2007/2008,4,10,5,5,-Inf
2006/2007,11,46,2007/2008,5,21,11,10,-Inf
2006/2007,11,47,2007/2008,6,18,5,13,-Inf
2006/2007,11,48,2007/2008,7,21,5,16,-Inf
2006/2007,11,49,2007/2008,8,34,6,28,-Inf
2006/2007,11,50,2007/2008,9,25,6,19,-Inf
2006/2007,11,51,2007/2008,10,34,4,30,-Inf
2006/2007,11,52,2007/2008,11,33,4,29,-Inf
2006/2007,12,1,2006/2007,13,14,56,42,-Inf
2006/2007,12,2,2006/2007,14,12,75,63,-Inf
2006/2007,12,3,2006/2007,15,16,83,67,-Inf
2006/2007,12,4,2006/2007,16,10,82,72,-Inf
2006/2007,12,5,2006/2007,17,16,126,110,-Inf
2006/2007,12,6,2006/2007,18,18,119,101,-Inf
2006/2007,12,7,2006/2007,19,15,137,122,-Inf
2006/2007,12,8,2006/2007,20,23,131,108,-Inf
2006/2007,12,9,2006/2007,21,17,112,95,-Inf
2006/2007,12,10,2006/2007,22,33,82,49,-Inf
2006/2007,12,11,2006/2007,23,15,73,58,-Inf
2006/2007,12,12,2006/2007,24,13,43,30,-Inf
2006/2007,12,13,2006/2007,25,11,55,44,-Inf
2006/2007,12,14,2006/2007,26,14,55,41,-Inf
2006/2007,12,15,2006/2007,27,17,53,36,-Inf
2006/2007,12,16,2006/2007,28,19,46,27,-11.512925464970229
2006/2007,12,17,2006/2007,29,20,43,23,-Inf
2006/2007,12,18,2006/2007,30,12,29,17,-Inf
2006/2007,12,19,2006/2007,31,21,22,1,-11.512925464970229
2006/2007,12,20,2006/2007,32,7,26,19,-Inf
2006/2007,12,21,2006/2007,33,19,13,6,-Inf
2006/2007,12,22,2006/2007,34,10,17,7,-Inf
2006/2007,12,23,2006/2007,35,13,8,5,-Inf
2006/2007,12,24,2006/2007,36,10,13,3,-11.512925464970229
2006/2007,12,25,2006/2007,37,8,10,2,-11.512925464970229
2006/2007,12,26,2006/2007,38,21,17,4,-Inf
2006/2007,12,27,2006/2007,39,11,19,8,-Inf
2006/2007,12,28,2006/2007,40,9,9,0,-0.36838610986674425
2006/2007,12,29,2006/2007,41,14,9,5,-11.512925464970229
2006/2007,12,30,2006/2007,42,14,9,5,-Inf
2006/2007,12,31,2006/2007,43,15,3,12,-11.512925464970229
2006/2007,12,32,2006/2007,44,18,7,11,-Inf
2006/2007,12,33,2006/2007,45,16,7,9,-Inf
2006/2007,12,34,2006/2007,46,12,0,12,-Inf
2006/2007,12,35,2006/2007,47,20,2,18,-Inf
2006/2007,12,36,2006/2007,48,8,3,5,-10.819778284410283
2006/2007,12,37,2006/2007,49,3,3,0,-0.3607546833411064
2006/2007,12,38,2006/2007,50,13,1,12,-Inf
2006/2007,12,39,2006/2007,51,4,3,1,-10.819778284410283
2006/2007,12,40,2006/2007,52,1,3,2,-Inf
2006/2007,12,41,2007/2008,1,10,3,7,-Inf
2006/2007,12,42,2007/2008,2,8,7,1,-11.512925464970229
2006/2007,12,43,2007/2008,3,13,3,10,-Inf
2006/2007,12,44,2007/2008,4,10,5,5,-Inf
2006/2007,12,45,2007/2008,5,21,11,10,-Inf
2006/2007,12,46,2007/2008,6,18,5,13,-Inf
2006/2007,12,47,2007/2008,7,21,5,16,-Inf
2006/2007,12,48,2007/2008,8,34,6,28,-Inf
2006/2007,12,49,2007/2008,9,25,6,19,-11.512925464970229
2006/2007,12,50,2007/2008,10,34,4,30,-Inf
2006/2007,12,51,2007/2008,11,33,4,29,-Inf
2006/2007,12,52,2007/2008,12,40,8,32,-Inf
2006/2007,13,1,2006/2007,14,12,75,63,-Inf
2006/2007,13,2,2006/2007,15,16,83,67,-Inf
2006/2007,13,3,2006/2007,16,10,82,72,-Inf
2006/2007,13,4,2006/2007,17,16,126,110,-Inf
2006/2007,13,5,2006/2007,18,18,119,101,-Inf
2006/2007,13,6,2006/2007,19,15,137,122,-Inf
2006/2007,13,7,2006/2007,20,23,131,108,-Inf
2006/2007,13,8,2006/2007,21,17,112,95,-Inf
2006/2007,13,9,2006/2007,22,33,82,49,-Inf
2006/2007,13,10,2006/2007,23,15,73,58,-11.512925464970229
2006/2007,13,11,2006/2007,24,13,43,30,-Inf
2006/2007,13,12,2006/2007,25,11,55,44,-Inf
2006/2007,13,13,2006/2007,26,14,55,41,-Inf
2006/2007,13,14,2006/2007,27,17,53,36,-11.512925464970229
2006/2007,13,15,2006/2007,28,19,46,27,-Inf
2006/2007,13,16,2006/2007,29,20,43,23,-11.512925464970229
2006/2007,13,17,2006/2007,30,12,29,17,-Inf
2006/2007,13,18,2006/2007,31,21,22,1,-10.819778284410283
2006/2007,13,19,2006/2007,32,7,26,19,-Inf
2006/2007,13,20,2006/2007,33,19,13,6,-Inf
2006/2007,13,21,2006/2007,34,10,17,7,-11.512925464970229
2006/2007,13,22,2006/2007,35,13,8,5,-Inf
2006/2007,13,23,2006/2007,36,10,13,3,-Inf
2006/2007,13,24,2006/2007,37,8,10,2,-10.819778284410283
2006/2007,13,25,2006/2007,38,21,17,4,-Inf
2006/2007,13,26,2006/2007,39,11,19,8,-Inf
2006/2007,13,27,2006/2007,40,9,9,0,-0.369297126725721
2006/2007,13,28,2006/2007,41,14,9,5,-Inf
2006/2007,13,29,2006/2007,42,14,9,5,-Inf
2006/2007,13,30,2006/2007,43,15,3,12,-Inf
2006/2007,13,31,2006/2007,44,18,7,11,-Inf
2006/2007,13,32,2006/2007,45,16,7,9,-11.512925464970229
2006/2007,13,33,2006/2007,46,12,0,12,-Inf
2006/2007,13,34,2006/2007,47,20,2,18,-Inf
2006/2007,13,35,2006/2007,48,8,3,5,-Inf
2006/2007,13,36,2006/2007,49,3,3,0,-0.3617018433671415
2006/2007,13,37,2006/2007,50,13,1,12,-Inf
2006/2007,13,38,2006/2007,51,4,3,1,-Inf
2006/2007,13,39,2006/2007,52,1,3,2,-Inf
2006/2007,13,40,2007/2008,1,10,3,7,-Inf
2006/2007,13,41,2007/2008,2,8,7,1,-11.512925464970229
2006/2007,13,42,2007/2008,3,13,3,10,-Inf
2006/2007,13,43,2007/2008,4,10,5,5,-Inf
2006/2007,13,44,2007/2008,5,21,11,10,-Inf
2006/2007,13,45,2007/2008,6,18,5,13,-Inf
2006/2007,13,46,2007/2008,7,21,5,16,-Inf
2006/2007,13,47,2007/2008,8,34,6,28,-Inf
2006/2007,13,48,2007/2008,9,25,6,19,-Inf
2006/2007,13,49,2007/2008,10,34,4,30,-Inf
2006/2007,13,50,2007/2008,11,33,4,29,-Inf
2006/2007,13,51,2007/2008,12,40,8,32,-Inf
2006/2007,13,52,2007/2008,13,42,14,28,-Inf
2006/2007,14,1,2006/2007,15,16,83,67,-Inf
2006/2007,14,2,2006/2007,16,10,82,72,-Inf
2006/2007,14,3,2006/2007,17,16,126,110,-Inf
2006/2007,14,4,2006/2007,18,18,119,101,-Inf
2006/2007,14,5,2006/2007,19,15,137,122,-Inf
2006/2007,14,6,2006/2007,20,23,131,108,-Inf
2006/2007,14,7,2006/2007,21,17,112,95,-Inf
2006/2007,14,8,2006/2007,22,33,82,49,-Inf
2006/2007,14,9,2006/2007,23,15,73,58,-Inf
2006/2007,14,10,2006/2007,24,13,43,30,-Inf
2006/2007,14,11,2006/2007,25,11,55,44,-Inf
2006/2007,14,12,2006/2007,26,14,55,41,-Inf
2006/2007,14,13,2006/2007,27,17,53,36,-Inf
2006/2007,14,14,2006/2007,28,19,46,27,-Inf
2006/2007,14,15,2006/2007,29,20,43,23,-Inf
2006/2007,14,16,2006/2007,30,12,29,17,-Inf
2006/2007,14,17,2006/2007,31,21,22,1,-10.41431317630212
2006/2007,14,18,2006/2007,32,7,26,19,-Inf
2006/2007,14,19,2006/2007,33,19,13,6,-Inf
2006/2007,14,20,2006/2007,34,10,17,7,-11.512925464970229
2006/2007,14,21,2006/2007,35,13,8,5,-Inf
2006/2007,14,22,2006/2007,36,10,13,3,-11.512925464970229
2006/2007,14,23,2006/2007,37,8,10,2,-11.512925464970229
2006/2007,14,24,2006/2007,38,21,17,4,-Inf
2006/2007,14,25,2006/2007,39,11,19,8,-Inf
2006/2007,14,26,2006/2007,40,9,9,0,-0.3729204766324372
2006/2007,14,27,2006/2007,41,14,9,5,-Inf
2006/2007,14,28,2006/2007,42,14,9,5,-Inf
2006/2007,14,29,2006/2007,43,15,3,12,-Inf
2006/2007,14,30,2006/2007,44,18,7,11,-Inf
2006/2007,14,31,2006/2007,45,16,7,9,-Inf
2006/2007,14,32,2006/2007,46,12,0,12,-Inf
2006/2007,14,33,2006/2007,47,20,2,18,-Inf
2006/2007,14,34,2006/2007,48,8,3,5,-Inf
2006/2007,14,35,2006/2007,49,3,3,0,-0.35886305038427047
2006/2007,14,36,2006/2007,50,13,1,12,-Inf
2006/2007,14,37,2006/2007,51,4,3,1,-Inf
2006/2007,14,38,2006/2007,52,1,3,2,-11.512925464970229
2006/2007,14,39,2007/2008,1,10,3,7,-11.512925464970229
2006/2007,14,40,2007/2008,2,8,7,1,-11.512925464970229
2006/2007,14,41,2007/2008,3,13,3,10,-Inf
2006/2007,14,42,2007/2008,4,10,5,5,-11.512925464970229
2006/2007,14,43,2007/2008,5,21,11,10,-Inf
2006/2007,14,44,2007/2008,6,18,5,13,-Inf
2006/2007,14,45,2007/2008,7,21,5,16,-Inf
2006/2007,14,46,2007/2008,8,34,6,28,-Inf
2006/2007,14,47,2007/2008,9,25,6,19,-Inf
2006/2007,14,48,2007/2008,10,34,4,30,-Inf
2006/2007,14,49,2007/2008,11,33,4,29,-Inf
2006/2007,14,50,2007/2008,12,40,8,32,-Inf
2006/2007,14,51,2007/2008,13,42,14,28,-Inf
2006/2007,14,52,2007/2008,14,36,12,24,-Inf
2006/2007,15,1,2006/2007,16,10,82,72,-Inf
2006/2007,15,2,2006/2007,17,16,126,110,-Inf
2006/2007,15,3,2006/2007,18,18,119,101,-Inf
2006/2007,15,4,2006/2007,19,15,137,122,-Inf
2006/2007,15,5,2006/2007,20,23,131,108,-Inf
2006/2007,15,6,2006/2007,21,17,112,95,-Inf
2006/2007,15,7,2006/2007,22,33,82,49,-Inf
2006/2007,15,8,2006/2007,23,15,73,58,-Inf
2006/2007,15,9,2006/2007,24,13,43,30,-Inf
2006/2007,15,10,2006/2007,25,11,55,44,-Inf
2006/2007,15,11,2006/2007,26,14,55,41,-Inf
2006/2007,15,12,2006/2007,27,17,53,36,-Inf
2006/2007,15,13,2006/2007,28,19,46,27,-Inf
2006/2007,15,14,2006/2007,29,20,43,23,-Inf
2006/2007,15,15,2006/2007,30,12,29,17,-Inf
2006/2007,15,16,2006/2007,31,21,22,1,-Inf
2006/2007,15,17,2006/2007,32,7,26,19,-Inf
2006/2007,15,18,2006/2007,33,19,13,6,-11.512925464970229
2006/2007,15,19,2006/2007,34,10,17,7,-Inf
2006/2007,15,20,2006/2007,35,13,8,5,-Inf
2006/2007,15,21,2006/2007,36,10,13,3,-Inf
2006/2007,15,22,2006/2007,37,8,10,2,-Inf
2006/2007,15,23,2006/2007,38,21,17,4,-Inf
2006/2007,15,24,2006/2007,39,11,19,8,-Inf
2006/2007,15,25,2006/2007,40,9,9,0,-0.3733416362799513
2006/2007,15,26,2006/2007,41,14,9,5,-Inf
2006/2007,15,27,2006/2007,42,14,9,5,-Inf
2006/2007,15,28,2006/2007,43,15,3,12,-Inf
2006/2007,15,29,2006/2007,44,18,7,11,-Inf
2006/2007,15,30,2006/2007,45,16,7,9,-Inf
2006/2007,15,31,2006/2007,46,12,0,12,-Inf
2006/2007,15,32,2006/2007,47,20,2,18,-Inf
2006/2007,15,33,2006/2007,48,8,3,5,-Inf
2006/2007,15,34,2006/2007,49,3,3,0,-0.36538418811581863
2006/2007,15,35,2006/2007,50,13,1,12,-Inf
2006/2007,15,36,2006/2007,51,4,3,1,-Inf
2006/2007,15,37,2006/2007,52,1,3,2,-10.819778284410283
2006/2007,15,38,2007/2008,1,10,3,7,-Inf
2006/2007,15,39,2007/2008,2,8,7,1,-11.512925464970229
2006/2007,15,40,2007/2008,3,13,3,10,-Inf
2006/2007,15,41,2007/2008,4,10,5,5,-Inf
2006/2007,15,42,2007/2008,5,21,11,10,-Inf
2006/2007,15,43,2007/2008,6,18,5,13,-Inf
2006/2007,15,44,2007/2008,7,21,5,16,-Inf
2006/2007,15,45,2007/2008,8,34,6,28,-Inf
2006/2007,15,46,2007/2008,9,25,6,19,-Inf
2006/2007,15,47,2007/2008,10,34,4,30,-Inf
2006/2007,15,48,2007/2008,11,33,4,29,-Inf
2006/2007,15,49,2007/2008,12,40,8,32,-Inf
2006/2007,15,50,2007/2008,13,42,14,28,-Inf
2006/2007,15,51,2007/2008,14,36,12,24,-Inf
2006/2007,15,52,2007/2008,15,72,16,56,-Inf
2006/2007,16,1,2006/2007,17,16,126,110,-Inf
2006/2007,16,2,2006/2007,18,18,119,101,-Inf
2006/2007,16,3,2006/2007,19,15,137,122,-Inf
2006/2007,16,4,2006/2007,20,23,131,108,-Inf
2006/2007,16,5,2006/2007,21,17,112,95,-11.512925464970229
2006/2007,16,6,2006/2007,22,33,82,49,-Inf
2006/2007,16,7,2006/2007,23,15,73,58,-Inf
2006/2007,16,8,2006/2007,24,13,43,30,-Inf
2006/2007,16,9,2006/2007,25,11,55,44,-Inf
2006/2007,16,10,2006/2007,26,14,55,41,-Inf
2006/2007,16,11,2006/2007,27,17,53,36,-Inf
2006/2007,16,12,2006/2007,28,19,46,27,-Inf
2006/2007,16,13,2006/2007,29,20,43,23,-Inf
2006/2007,16,14,2006/2007,30,12,29,17,-Inf
2006/2007,16,15,2006/2007,31,21,22,1,-10.126631103850338
2006/2007,16,16,2006/2007,32,7,26,19,-11.512925464970229
2006/2007,16,17,2006/2007,33,19,13,6,-11.512925464970229
2006/2007,16,18,2006/2007,34,10,17,7,-Inf
2006/2007,16,19,2006/2007,35,13,8,5,-Inf
2006/2007,16,20,2006/2007,36,10,13,3,-11.512925464970229
2006/2007,16,21,2006/2007,37,8,10,2,-10.819778284410283
2006/2007,16,22,2006/2007,38,21,17,4,-Inf
2006/2007,16,23,2006/2007,39,11,19,8,-Inf
2006/2007,16,24,2006/2007,40,9,9,0,-0.37867226352543604
2006/2007,16,25,2006/2007,41,14,9,5,-Inf
2006/2007,16,26,2006/2007,42,14,9,5,-Inf
2006/2007,16,27,2006/2007,43,15,3,12,-Inf
2006/2007,16,28,2006/2007,44,18,7,11,-Inf
2006/2007,16,29,2006/2007,45,16,7,9,-Inf
2006/2007,16,30,2006/2007,46,12,0,12,-Inf
2006/2007,16,31,2006/2007,47,20,2,18,-Inf
2006/2007,16,32,2006/2007,48,8,3,5,-Inf
2006/2007,16,33,2006/2007,49,3,3,0,-0.3637283321280833
2006/2007,16,34,2006/2007,50,13,1,12,-Inf
2006/2007,16,35,2006/2007,51,4,3,1,-10.819778284410283
2006/2007,16,36,2006/2007,52,1,3,2,-10.819778284410283
2006/2007,16,37,2007/2008,1,10,3,7,-Inf
2006/2007,16,38,2007/2008,2,8,7,1,-Inf
2006/2007,16,39,2007/2008,3,13,3,10,-Inf
2006/2007,16,40,2007/2008,4,10,5,5,-Inf
2006/2007,16,41,2007/2008,5,21,11,10,-Inf
2006/2007,16,42,2007/2008,6,18,5,13,-Inf
2006/2007,16,43,2007/2008,7,21,5,16,-Inf
2006/2007,16,44,2007/2008,8,34,6,28,-Inf
2006/2007,16,45,2007/2008,9,25,6,19,-Inf
2006/2007,16,46,2007/2008,10,34,4,30,-Inf
2006/2007,16,47,2007/2008,11,33,4,29,-Inf
2006/2007,16,48,2007/2008,12,40,8,32,-Inf
2006/2007,16,49,2007/2008,13,42,14,28,-Inf
2006/2007,16,50,2007/2008,14,36,12,24,-Inf
2006/2007,16,51,2007/2008,15,72,16,56,-Inf
2006/2007,16,52,2007/2008,16,75,10,65,-Inf
2006/2007,17,1,2006/2007,18,18,119,101,-Inf
2006/2007,17,2,2006/2007,19,15,137,122,-Inf
2006/2007,17,3,2006/2007,20,23,131,108,-Inf
2006/2007,17,4,2006/2007,21,17,112,95,-Inf
2006/2007,17,5,2006/2007,22,33,82,49,-Inf
2006/2007,17,6,2006/2007,23,15,73,58,-Inf
2006/2007,17,7,2006/2007,24,13,43,30,-Inf
2006/2007,17,8,2006/2007,25,11,55,44,-Inf
2006/2007,17,9,2006/2007,26,14,55,41,-Inf
2006/2007,17,10,2006/2007,27,17,53,36,-Inf
2006/2007,17,11,2006/2007,28,19,46,27,-Inf
2006/2007,17,12,2006/2007,29,20,43,23,-Inf
2006/2007,17,13,2006/2007,30,12,29,17,-Inf
2006/2007,17,14,2006/2007,31,21,22,1,-11.512925464970229
2006/2007,17,15,2006/2007,32,7,26,19,-Inf
2006/2007,17,16,2006/2007,33,19,13,6,-Inf
2006/2007,17,17,2006/2007,34,10,17,7,-10.819778284410283
2006/2007,17,18,2006/2007,35,13,8,5,-11.512925464970229
2006/2007,17,19,2006/2007,36,10,13,3,-11.512925464970229
2006/2007,17,20,2006/2007,37,8,10,2,-10.41431317630212
2006/2007,17,21,2006/2007,38,21,17,4,-11.512925464970229
2006/2007,17,22,2006/2007,39,11,19,8,-Inf
2006/2007,17,23,2006/2007,40,9,9,0,-0.378205062489096
2006/2007,17,24,2006/2007,41,14,9,5,-Inf
2006/2007,17,25,2006/2007,42,14,9,5,-Inf
2006/2007,17,26,2006/2007,43,15,3,12,-Inf
2006/2007,17,27,2006/2007,44,18,7,11,-Inf
2006/2007,17,28,2006/2007,45,16,7,9,-Inf
2006/2007,17,29,2006/2007,46,12,0,12,-Inf
2006/2007,17,30,2006/2007,47,20,2,18,-Inf
2006/2007,17,31,2006/2007,48,8,3,5,-Inf
2006/2007,17,32,2006/2007,49,3,3,0,-0.36391537845137023
2006/2007,17,33,2006/2007,50,13,1,12,-Inf
2006/2007,17,34,2006/2007,51,4,3,1,-11.512925464970229
2006/2007,17,35,2006/2007,52,1,3,2,-11.512925464970229
2006/2007,17,36,2007/2008,1,10,3,7,-Inf
2006/2007,17,37,2007/2008,2,8,7,1,-Inf
2006/2007,17,38,2007/2008,3,13,3,10,-Inf
2006/2007,17,39,2007/2008,4,10,5,5,-Inf
2006/2007,17,40,2007/2008,5,21,11,10,-11.512925464970229
2006/2007,17,41,2007/2008,6,18,5,13,-Inf
2006/2007,17,42,2007/2008,7,21,5,16,-Inf
2006/2007,17,43,2007/2008,8,34,6,28,-Inf
2006/2007,17,44,2007/2008,9,25,6,19,-Inf
2006/2007,17,45,2007/2008,10,34,4,30,-11.512925464970229
2006/2007,17,46,2007/2008,11,33,4,29,-Inf
2006/2007,17,47,2007/2008,12,40,8,32,-Inf
2006/2007,17,48,2007/2008,13,42,14,28,-Inf
2006/2007,17,49,2007/2008,14,36,12,24,-Inf
2006/2007,17,50,2007/2008,15,72,16,56,-Inf
2006/2007,17,51,2007/2008,16,75,10,65,-Inf
2006/2007,17,52,2007/2008,17,76,16,60,-Inf
2006/2007,18,1,2006/2007,19,15,137,122,-Inf
2006/2007,18,2,2006/2007,20,23,131,108,-Inf
2006/2007,18,3,2006/2007,21,17,112,95,-Inf
2006/2007,18,4,2006/2007,22,33,82,49,-Inf
2006/2007,18,5,2006/2007,23,15,73,58,-Inf
2006/2007,18,6,2006/2007,24,13,43,30,-Inf
2006/2007,18,7,2006/2007,25,11,55,44,-Inf
2006/2007,18,8,2006/2007,26,14,55,41,-Inf
2006/2007,18,9,2006/2007,27,17,53,36,-Inf
2006/2007,18,10,2006/2007,28,19,46,27,-Inf
2006/2007,18,11,2006/2007,29,20,43,23,-Inf
2006/2007,18,12,2006/2007,30,12,29,17,-Inf
2006/2007,18,13,2006/2007,31,21,22,1,-11.512925464970229
2006/2007,18,14,2006/2007,32,7,26,19,-Inf
2006/2007,18,15,2006/2007,33,19,13,6,-Inf
2006/2007,18,16,2006/2007,34,10,17,7,-Inf
2006/2007,18,17,2006/2007,35,13,8,5,-11.512925464970229
2006/2007,18,18,2006/2007,36,10,13,3,-Inf
2006/2007,18,19,2006/2007,37,8,10,2,-Inf
2006/2007,18,20,2006/2007,38,21,17,4,-Inf
2006/2007,18,21,2006/2007,39,11,19,8,-Inf
2006/2007,18,22,2006/2007,40,9,9,0,-0.38153864259206216
2006/2007,18,23,2006/2007,41,14,9,5,-Inf
2006/2007,18,24,2006/2007,42,14,9,5,-Inf
2006/2007,18,25,2006/2007,43,15,3,12,-Inf
2006/2007,18,26,2006/2007,44,18,7,11,-Inf
2006/2007,18,27,2006/2007,45,16,7,9,-Inf
2006/2007,18,28,2006/2007,46,12,0,12,-Inf
2006/2007,18,29,2006/2007,47,20,2,18,-Inf
2006/2007,18,30,2006/2007,48,8,3,5,-Inf
2006/2007,18,31,2006/2007,49,3,3,0,-0.3640017193251932
2006/2007,18,32,2006/2007,50,13,1,12,-Inf
2006/2007,18,33,2006/2007,51,4,3,1,-11.512925464970229
2006/2007,18,34,2006/2007,52,1,3,2,-11.512925464970229
2006/2007,18,35,2007/2008,1,10,3,7,-Inf
2006/2007,18,36,2007/2008,2,8,7,1,-Inf
2006/2007,18,37,2007/2008,3,13,3,10,-Inf
2006/2007,18,38,2007/2008,4,10,5,5,-Inf
2006/2007,18,39,2007/2008,5,21,11,10,-Inf
2006/2007,18,40,2007/2008,6,18,5,13,-Inf
2006/2007,18,41,2007/2008,7,21,5,16,-11.512925464970229
2006/2007,18,42,2007/2008,8,34,6,28,-Inf
2006/2007,18,43,2007/2008,9,25,6,19,-Inf
2006/2007,18,44,2007/2008,10,34,4,30,-Inf
2006/2007,18,45,2007/2008,11,33,4,29,-11.512925464970229
2006/2007,18,46,2007/2008,12,40,8,32,-Inf
2006/2007,18,47,2007/2008,13,42,14,28,-Inf
2006/2007,18,48,2007/2008,14,36,12,24,-Inf
2006/2007,18,49,2007/2008,15,72,16,56,-Inf
2006/2007,18,50,2007/2008,16,75,10,65,-Inf
2006/2007,18,51,2007/2008,17,76,16,60,-Inf
2006/2007,18,52,2007/2008,18,92,18,74,-Inf
2006/2007,19,1,2006/2007,20,23,131,108,-Inf
2006/2007,19,2,2006/2007,21,17,112,95,-Inf
2006/2007,19,3,2006/2007,22,33,82,49,-Inf
2006/2007,19,4,2006/2007,23,15,73,58,-Inf
2006/2007,19,5,2006/2007,24,13,43,30,-Inf
2006/2007,19,6,2006/2007,25,11,55,44,-Inf
2006/2007,19,7,2006/2007,26,14,55,41,-Inf
2006/2007,19,8,2006/2007,27,17,53,36,-Inf
2006/2007,19,9,2006/2007,28,19,46,27,-Inf
2006/2007,19,10,2006/2007,29,20,43,23,-Inf
2006/2007,19,11,2006/2007,30,12,29,17,-Inf
2006/2007,19,12,2006/2007,31,21,22,1,-10.819778284410283
2006/2007,19,13,2006/2007,32,7,26,19,-Inf
2006/2007,19,14,2006/2007,33,19,13,6,-Inf
2006/2007,19,15,2006/2007,34,10,17,7,-Inf
2006/2007,19,16,2006/2007,35,13,8,5,-Inf
2006/2007,19,17,2006/2007,36,10,13,3,-Inf
2006/2007,19,18,2006/2007,37,8,10,2,-10.819778284410283
2006/2007,19,19,2006/2007,38,21,17,4,-Inf
2006/2007,19,20,2006/2007,39,11,19,8,-Inf
2006/2007,19,21,2006/2007,40,9,9,0,-0.3830629214197785
2006/2007,19,22,2006/2007,41,14,9,5,-Inf
2006/2007,19,23,2006/2007,42,14,9,5,-Inf
2006/2007,19,24,2006/2007,43,15,3,12,-11.512925464970229
2006/2007,19,25,2006/2007,44,18,7,11,-Inf
2006/2007,19,26,2006/2007,45,16,7,9,-Inf
2006/2007,19,27,2006/2007,46,12,0,12,-Inf
2006/2007,19,28,2006/2007,47,20,2,18,-Inf
2006/2007,19,29,2006/2007,48,8,3,5,-Inf
2006/2007,19,30,2006/2007,49,3,3,0,-0.368747525173001
2006/2007,19,31,2006/2007,50,13,1,12,-Inf
2006/2007,19,32,2006/2007,51,4,3,1,-Inf
2006/2007,19,33,2006/2007,52,1,3,2,-Inf
2006/2007,19,34,2007/2008,1,10,3,7,-Inf
2006/2007,19,35,2007/2008,2,8,7,1,-10.819778284410283
2006/2007,19,36,2007/2008,3,13,3,10,-Inf
2006/2007,19,37,2007/2008,4,10,5,5,-Inf
2006/2007,19,38,2007/2008,5,21,11,10,-Inf
2006/2007,19,39,2007/2008,6,18,5,13,-Inf
2006/2007,19,40,2007/2008,7,21,5,16,-Inf
2006/2007,19,41,2007/2008,8,34,6,28,-Inf
2006/2007,19,42,2007/2008,9,25,6,19,-Inf
2006/2007,19,43,2007/2008,10,34,4,30,-Inf
2006/2007,19,44,2007/2008,11,33,4,29,-Inf
2006/2007,19,45,2007/2008,12,40,8,32,-Inf
2006/2007,19,46,2007/2008,13,42,14,28,-Inf
2006/2007,19,47,2007/2008,14,36,12,24,-Inf
2006/2007,19,48,2007/2008,15,72,16,56,-Inf
2006/2007,19,49,2007/2008,16,75,10,65,-Inf
2006/2007,19,50,2007/2008,17,76,16,60,-Inf
2006/2007,19,51,2007/2008,18,92,18,74,-Inf
2006/2007,19,52,2007/2008,19,71,15,56,-Inf
2006/2007,1,1,2006/2007,2,7,2,5,-Inf
2006/2007,1,2,2006/2007,3,3,6,3,-11.512925464970229
2006/2007,1,3,2006/2007,4,5,3,2,-Inf
2006/2007,1,4,2006/2007,5,11,4,7,-11.512925464970229
2006/2007,1,5,2006/2007,6,5,10,5,-11.512925464970229
2006/2007,1,6,2006/2007,7,5,12,7,-Inf
2006/2007,1,7,2006/2007,8,6,21,15,-11.512925464970229
2006/2007,1,8,2006/2007,9,6,26,20,-Inf
2006/2007,1,9,2006/2007,10,4,21,17,-Inf
2006/2007,1,10,2006/2007,11,4,30,26,-Inf
2006/2007,1,11,2006/2007,12,8,45,37,-Inf
2006/2007,1,12,2006/2007,13,14,56,42,-Inf
2006/2007,1,13,2006/2007,14,12,75,63,-Inf
2006/2007,1,14,2006/2007,15,16,83,67,-Inf
2006/2007,1,15,2006/2007,16,10,82,72,-Inf
2006/2007,1,16,2006/2007,17,16,126,110,-Inf
2006/2007,1,17,2006/2007,18,18,119,101,-Inf
2006/2007,1,18,2006/2007,19,15,137,122,-Inf
2006/2007,1,19,2006/2007,20,23,131,108,-Inf
2006/2007,1,20,2006/2007,21,17,112,95,-Inf
2006/2007,1,21,2006/2007,22,33,82,49,-Inf
2006/2007,1,22,2006/2007,23,15,73,58,-Inf
2006/2007,1,23,2006/2007,24,13,43,30,-Inf
2006/2007,1,24,2006/2007,25,11,55,44,-Inf
2006/2007,1,25,2006/2007,26,14,55,41,-Inf
2006/2007,1,26,2006/2007,27,17,53,36,-Inf
2006/2007,1,27,2006/2007,28,19,46,27,-Inf
2006/2007,1,28,2006/2007,29,20,43,23,-Inf
2006/2007,1,29,2006/2007,30,12,29,17,-Inf
2006/2007,1,30,2006/2007,31,21,22,1,-Inf
2006/2007,1,31,2006/2007,32,7,26,19,-Inf
2006/2007,1,32,2006/2007,33,19,13,6,-Inf
2006/2007,1,33,2006/2007,34,10,17,7,-Inf
2006/2007,1,34,2006/2007,35,13,8,5,-Inf
2006/2007,1,35,2006/2007,36,10,13,3,-11.512925464970229
2006/2007,1,36,2006/2007,37,8,10,2,-Inf
2006/2007,1,37,2006/2007,38,21,17,4,-Inf
2006/2007,1,38,2006/2007,39,11,19,8,-Inf
2006/2007,1,39,2006/2007,40,9,9,0,-0.33029734059313043
2006/2007,1,40,2006/2007,41,14,9,5,-Inf
2006/2007,1,41,2006/2007,42,14,9,5,-Inf
2006/2007,1,42,2006/2007,43,15,3,12,-Inf
2006/2007,1,43,2006/2007,44,18,7,11,-Inf
2006/2007,1,44,2006/2007,45,16,7,9,-Inf
2006/2007,1,45,2006/2007,46,12,0,12,-Inf
2006/2007,1,46,2006/2007,47,20,2,18,-11.512925464970229
2006/2007,1,47,2006/2007,48,8,3,5,-Inf
2006/2007,1,48,2006/2007,49,3,3,0,-0.34205378451911983
2006/2007,1,49,2006/2007,50,13,1,12,-Inf
2006/2007,1,50,2006/2007,51,4,3,1,-11.512925464970229
2006/2007,1,51,2006/2007,52,1,3,2,-11.512925464970229
2006/2007,1,52,2007/2008,1,10,3,7,-11.512925464970229
2006/2007,20,1,2006/2007,21,17,112,95,-Inf
2006/2007,20,2,2006/2007,22,33,82,49,-Inf
2006/2007,20,3,2006/2007,23,15,73,58,-Inf
2006/2007,20,4,2006/2007,24,13,43,30,-Inf
2006/2007,20,5,2006/2007,25,11,55,44,-Inf
2006/2007,20,6,2006/2007,26,14,55,41,-Inf
2006/2007,20,7,2006/2007,27,17,53,36,-Inf
2006/2007,20,8,2006/2007,28,19,46,27,-11.512925464970229
2006/2007,20,9,2006/2007,29,20,43,23,-Inf
2006/2007,20,10,2006/2007,30,12,29,17,-11.512925464970229
2006/2007,20,11,2006/2007,31,21,22,1,-9.721165995742174
2006/2007,20,12,2006/2007,32,7,26,19,-Inf
2006/2007,20,13,2006/2007,33,19,13,6,-Inf
2006/2007,20,14,2006/2007,34,10,17,7,-11.512925464970229
2006/2007,20,15,2006/2007,35,13,8,5,-Inf
2006/2007,20,16,2006/2007,36,10,13,3,-Inf
2006/2007,20,17,2006/2007,37,8,10,2,-10.41431317630212
2006/2007,20,18,2006/2007,38,21,17,4,-11.512925464970229
2006/2007,20,19,2006/2007,39,11,19,8,-Inf
2006/2007,20,20,2006/2007,40,9,9,0,-0.3830335864436858
2006/2007,20,21,2006/2007,41,14,9,5,-Inf
2006/2007,20,22,2006/2007,42,14,9,5,-Inf
2006/2007,20,23,2006/2007,43,15,3,12,-Inf
2006/2007,20,24,2006/2007,44,18,7,11,-Inf
2006/2007,20,25,2006/2007,45,16,7,9,-Inf
2006/2007,20,26,2006/2007,46,12,0,12,-Inf
2006/2007,20,27,2006/2007,47,20,2,18,-Inf
2006/2007,20,28,2006/2007,48,8,3,5,-Inf
2006/2007,20,29,2006/2007,49,3,3,0,-0.36806817241103396
2006/2007,20,30,2006/2007,50,13,1,12,-Inf
2006/2007,20,31,2006/2007,51,4,3,1,-11.512925464970229
2006/2007,20,32,2006/2007,52,1,3,2,-11.512925464970229
2006/2007,20,33,2007/2008,1,10,3,7,-Inf
2006/2007,20,34,2007/2008,2,8,7,1,-11.512925464970229
2006/2007,20,35,2007/2008,3,13,3,10,-Inf
2006/2007,20,36,2007/2008,4,10,5,5,-Inf
2006/2007,20,37,2007/2008,5,21,11,10,-Inf
2006/2007,20,38,2007/2008,6,18,5,13,-Inf
2006/2007,20,39,2007/2008,7,21,5,16,-Inf
2006/2007,20,40,2007/2008,8,34,6,28,-11.512925464970229
2006/2007,20,41,2007/2008,9,25,6,19,-Inf
2006/2007,20,42,2007/2008,10,34,4,30,-Inf
2006/2007,20,43,2007/2008,11,33,4,29,-Inf
2006/2007,20,44,2007/2008,12,40,8,32,-Inf
2006/2007,20,45,2007/2008,13,42,14,28,-11.512925464970229
2006/2007,20,46,2007/2008,14,36,12,24,-Inf
2006/2007,20,47,2007/2008,15,72,16,56,-Inf
2006/2007,20,48,2007/2008,16,75,10,65,-Inf
2006/2007,20,49,2007/2008,17,76,16,60,-Inf
2006/2007,20,50,2007/2008,18,92,18,74,-Inf
2006/2007,20,51,2007/2008,19,71,15,56,-Inf
2006/2007,20,52,2007/2008,20,112,23,89,-Inf
2006/2007,21,1,2006/2007,22,33,82,49,-Inf
2006/2007,21,2,2006/2007,23,15,73,58,-Inf
2006/2007,21,3,2006/2007,24,13,43,30,-Inf
2006/2007,21,4,2006/2007,25,11,55,44,-Inf
2006/2007,21,5,2006/2007,26,14,55,41,-Inf
2006/2007,21,6,2006/2007,27,17,53,36,-Inf
2006/2007,21,7,2006/2007,28,19,46,27,-Inf
2006/2007,21,8,2006/2007,29,20,43,23,-Inf
2006/2007,21,9,2006/2007,30,12,29,17,-Inf
2006/2007,21,10,2006/2007,31,21,22,1,-11.512925464970229
2006/2007,21,11,2006/2007,32,7,26,19,-Inf
2006/2007,21,12,2006/2007,33,19,13,6,-Inf
2006/2007,21,13,2006/2007,34,10,17,7,-Inf
2006/2007,21,14,2006/2007,35,13,8,5,-Inf
2006/2007,21,15,2006/2007,36,10,13,3,-Inf
2006/2007,21,16,2006/2007,37,8,10,2,-Inf
2006/2007,21,17,2006/2007,38,21,17,4,-Inf
2006/2007,21,18,2006/2007,39,11,19,8,-Inf
2006/2007,21,19,2006/2007,40,9,9,0,-0.38547132261328976
2006/2007,21,20,2006/2007,41,14,9,5,-Inf
2006/2007,21,21,2006/2007,42,14,9,5,-Inf
2006/2007,21,22,2006/2007,43,15,3,12,-Inf
2006/2007,21,23,2006/2007,44,18,7,11,-Inf
2006/2007,21,24,2006/2007,45,16,7,9,-Inf
2006/2007,21,25,2006/2007,46,12,0,12,-Inf
2006/2007,21,26,2006/2007,47,20,2,18,-Inf
2006/2007,21,27,2006/2007,48,8,3,5,-Inf
2006/2007,21,28,2006/2007,49,3,3,0,-0.368400563971349
2006/2007,21,29,2006/2007,50,13,1,12,-Inf
2006/2007,21,30,2006/2007,51,4,3,1,-Inf
2006/2007,21,31,2006/2007,52,1,3,2,-Inf
2006/2007,21,32,2007/2008,1,10,3,7,-Inf
2006/2007,21,33,2007/2008,2,8,7,1,-11.512925464970229
2006/2007,21,34,2007/2008,3,13,3,10,-Inf
2006/2007,21,35,2007/2008,4,10,5,5,-Inf
2006/2007,21,36,2007/2008,5,21,11,10,-Inf
2006/2007,21,37,2007/2008,6,18,5,13,-Inf
2006/2007,21,38,2007/2008,7,21,5,16,-Inf
2006/2007,21,39,2007/2008,8,34,6,28,-Inf
2006/2007,21,40,2007/2008,9,25,6,19,-Inf
2006/2007,21,41,2007/2008,10,34,4,30,-Inf
2006/2007,21,42,2007/2008,11,33,4,29,-Inf
2006/2007,21,43,2007/2008,12,40,8,32,-Inf
2006/2007,21,44,2007/2008,13,42,14,28,-Inf
2006/2007,21,45,2007/2008,14,36,12,24,-Inf
2006/2007,21,46,2007/2008,15,72,16,56,-Inf
2006/2007,21,47,2007/2008,16,75,10,65,-Inf
2006/2007,21,48,2007/2008,17,76,16,60,-Inf
2006/2007,21,49,2007/2008,18,92,18,74,-Inf
2006/2007,21,50,2007/2008,19,71,15,56,-Inf
2006/2007,21,51,2007/2008,20,112,23,89,-Inf
2006/2007,21,52,2007/2008,21,106,17,89,-Inf
2006/2007,22,1,2006/2007,23,15,73,58,-11.512925464970229
2006/2007,22,2,2006/2007,24,13,43,30,-Inf
2006/2007,22,3,2006/2007,25,11,55,44,-Inf
2006/2007,22,4,2006/2007,26,14,55,41,-Inf
2006/2007,22,5,2006/2007,27,17,53,36,-Inf
2006/2007,22,6,2006/2007,28,19,46,27,-Inf
2006/2007,22,7,2006/2007,29,20,43,23,-Inf
2006/2007,22,8,2006/2007,30,12,29,17,-11.512925464970229
2006/2007,22,9,2006/2007,31,21,22,1,-10.819778284410283
2006/2007,22,10,2006/2007,32,7,26,19,-Inf
2006/2007,22,11,2006/2007,33,19,13,6,-Inf
2006/2007,22,12,2006/2007,34,10,17,7,-Inf
2006/2007,22,13,2006/2007,35,13,8,5,-Inf
2006/2007,22,14,2006/2007,36,10,13,3,-11.512925464970229
2006/2007,22,15,2006/2007,37,8,10,2,-11.512925464970229
2006/2007,22,16,2006/2007,38,21,17,4,-Inf
2006/2007,22,17,2006/2007,39,11,19,8,-Inf
2006/2007,22,18,2006/2007,40,9,9,0,-0.3908671782526074
2006/2007,22,19,2006/2007,41,14,9,5,-Inf
2006/2007,22,20,2006/2007,42,14,9,5,-Inf
2006/2007,22,21,2006/2007,43,15,3,12,-Inf
2006/2007,22,22,2006/2007,44,18,7,11,-Inf
2006/2007,22,23,2006/2007,45,16,7,9,-Inf
2006/2007,22,24,2006/2007,46,12,0,12,-Inf
2006/2007,22,25,2006/2007,47,20,2,18,-Inf
2006/2007,22,26,2006/2007,48,8,3,5,-Inf
2006/2007,22,27,2006/2007,49,3,3,0,-0.36926819279634593
2006/2007,22,28,2006/2007,50,13,1,12,-11.512925464970229
2006/2007,22,29,2006/2007,51,4,3,1,-10.41431317630212
2006/2007,22,30,2006/2007,52,1,3,2,-10.819778284410283
2006/2007,22,31,2007/2008,1,10,3,7,-Inf
2006/2007,22,32,2007/2008,2,8,7,1,-Inf
2006/2007,22,33,2007/2008,3,13,3,10,-Inf
2006/2007,22,34,2007/2008,4,10,5,5,-Inf
2006/2007,22,35,2007/2008,5,21,11,10,-Inf
2006/2007,22,36,2007/2008,6,18,5,13,-Inf
2006/2007,22,37,2007/2008,7,21,5,16,-Inf
2006/2007,22,38,2007/2008,8,34,6,28,-11.512925464970229
2006/2007,22,39,2007/2008,9,25,6,19,-Inf
2006/2007,22,40,2007/2008,10,34,4,30,-11.512925464970229
2006/2007,22,41,2007/2008,11,33,4,29,-Inf
2006/2007,22,42,2007/2008,12,40,8,32,-Inf
2006/2007,22,43,2007/2008,13,42,14,28,-Inf
2006/2007,22,44,2007/2008,14,36,12,24,-Inf
2006/2007,22,45,2007/2008,15,72,16,56,-Inf
2006/2007,22,46,2007/2008,16,75,10,65,-Inf
2006/2007,22,47,2007/2008,17,76,16,60,-Inf
2006/2007,22,48,2007/2008,18,92,18,74,-Inf
2006/2007,22,49,2007/2008,19,71,15,56,-Inf
2006/2007,22,50,2007/2008,20,112,23,89,-Inf
2006/2007,22,51,2007/2008,21,106,17,89,-Inf
2006/2007,22,52,2007/2008,22,101,33,68,-Inf
2006/2007,23,1,2006/2007,24,13,43,30,-Inf
2006/2007,23,2,2006/2007,25,11,55,44,-Inf
2006/2007,23,3,2006/2007,26,14,55,41,-Inf
2006/2007,23,4,2006/2007,27,17,53,36,-Inf
2006/2007,23,5,2006/2007,28,19,46,27,-Inf
2006/2007,23,6,2006/2007,29,20,43,23,-Inf
2006/2007,23,7,2006/2007,30,12,29,17,-Inf
2006/2007,23,8,2006/2007,31,21,22,1,-11.512925464970229
2006/2007,23,9,2006/2007,32,7,26,19,-Inf
2006/2007,23,10,2006/2007,33,19,13,6,-Inf
2006/2007,23,11,2006/2007,34,10,17,7,-Inf
2006/2007,23,12,2006/2007,35,13,8,5,-Inf
2006/2007,23,13,2006/2007,36,10,13,3,-Inf
2006/2007,23,14,2006/2007,37,8,10,2,-10.126631103850338
2006/2007,23,15,2006/2007,38,21,17,4,-Inf
2006/2007,23,16,2006/2007,39,11,19,8,-Inf
2006/2007,23,17,2006/2007,40,9,9,0,-0.39691674965820845
2006/2007,23,18,2006/2007,41,14,9,5,-11.512925464970229
2006/2007,23,19,2006/2007,42,14,9,5,-Inf
2006/2007,23,20,2006/2007,43,15,3,12,-Inf
2006/2007,23,21,2006/2007,44,18,7,11,-Inf
2006/2007,23,22,2006/2007,45,16,7,9,-Inf
2006/2007,23,23,2006/2007,46,12,0,12,-Inf
2006/2007,23,24,2006/2007,47,20,2,18,-Inf
2006/2007,23,25,2006/2007,48,8,3,5,-Inf
2006/2007,23,26,2006/2007,49,3,3,0,-0.37293499642654737
2006/2007,23,27,2006/2007,50,13,1,12,-Inf
2006/2007,23,28,2006/2007,51,4,3,1,-10.819778284410283
2006/2007,23,29,2006/2007,52,1,3,2,-Inf
2006/2007,23,30,2007/2008,1,10,3,7,-Inf
2006/2007,23,31,2007/2008,2,8,7,1,-11.512925464970229
2006/2007,23,32,2007/2008,3,13,3,10,-Inf
2006/2007,23,33,2007/2008,4,10,5,5,-Inf
2006/2007,23,34,2007/2008,5,21,11,10,-Inf
2006/2007,23,35,2007/2008,6,18,5,13,-Inf
2006/2007,23,36,2007/2008,7,21,5,16,-Inf
2006/2007,23,37,2007/2008,8,34,6,28,-Inf
2006/2007,23,38,2007/2008,9,25,6,19,-Inf
2006/2007,23,39,2007/2008,10,34,4,30,-Inf
2006/2007,23,40,2007/2008,11,33,4,29,-Inf
2006/2007,23,41,2007/2008,12,40,8,32,-Inf
2006/2007,23,42,2007/2008,13,42,14,28,-Inf
2006/2007,23,43,2007/2008,14,36,12,24,-Inf
2006/2007,23,44,2007/2008,15,72,16,56,-Inf
2006/2007,23,45,2007/2008,16,75,10,65,-Inf
2006/2007,23,46,2007/2008,17,76,16,60,-Inf
2006/2007,23,47,2007/2008,18,92,18,74,-Inf
2006/2007,23,48,2007/2008,19,71,15,56,-Inf
2006/2007,23,49,2007/2008,20,112,23,89,-Inf
2006/2007,23,50,2007/2008,21,106,17,89,-Inf
2006/2007,23,51,2007/2008,22,101,33,68,-Inf
2006/2007,23,52,2007/2008,23,170,15,155,-Inf
2006/2007,24,1,2006/2007,25,11,55,44,-Inf
2006/2007,24,2,2006/2007,26,14,55,41,-Inf
2006/2007,24,3,2006/2007,27,17,53,36,-Inf
2006/2007,24,4,2006/2007,28,19,46,27,-Inf
2006/2007,24,5,2006/2007,29,20,43,23,-Inf
2006/2007,24,6,2006/2007,30,12,29,17,-Inf
2006/2007,24,7,2006/2007,31,21,22,1,-11.512925464970229
2006/2007,24,8,2006/2007,32,7,26,19,-Inf
2006/2007,24,9,2006/2007,33,19,13,6,-Inf
2006/2007,24,10,2006/2007,34,10,17,7,-Inf
2006/2007,24,11,2006/2007,35,13,8,5,-Inf
2006/2007,24,12,2006/2007,36,10,13,3,-Inf
2006/2007,24,13,2006/2007,37,8,10,2,-Inf
2006/2007,24,14,2006/2007,38,21,17,4,-Inf
2006/2007,24,15,2006/2007,39,11,19,8,-Inf
2006/2007,24,16,2006/2007,40,9,9,0,-0.40117930529545553
2006/2007,24,17,2006/2007,41,14,9,5,-Inf
2006/2007,24,18,2006/2007,42,14,9,5,-Inf
2006/2007,24,19,2006/2007,43,15,3,12,-Inf
2006/2007,24,20,2006/2007,44,18,7,11,-Inf
2006/2007,24,21,2006/2007,45,16,7,9,-Inf
2006/2007,24,22,2006/2007,46,12,0,12,-Inf
2006/2007,24,23,2006/2007,47,20,2,18,-Inf
2006/2007,24,24,2006/2007,48,8,3,5,-Inf
2006/2007,24,25,2006/2007,49,3,3,0,-0.3733416362799513
2006/2007,24,26,2006/2007,50,13,1,12,-Inf
2006/2007,24,27,2006/2007,51,4,3,1,-Inf
2006/2007,24,28,2006/2007,52,1,3,2,-Inf
2006/2007,24,29,2007/2008,1,10,3,7,-Inf
2006/2007,24,30,2007/2008,2,8,7,1,-Inf
2006/2007,24,31,2007/2008,3,13,3,10,-11.512925464970229
2006/2007,24,32,2007/2008,4,10,5,5,-Inf
2006/2007,24,33,2007/2008,5,21,11,10,-Inf
2006/2007,24,34,2007/2008,6,18,5,13,-Inf
2006/2007,24,35,2007/2008,7,21,5,16,-Inf
2006/2007,24,36,2007/2008,8,34,6,28,-Inf
2006/2007,24,37,2007/2008,9,25,6,19,-Inf
2006/2007,24,38,2007/2008,10,34,4,30,-Inf
2006/2007,24,39,2007/2008,11,33,4,29,-Inf
2006/2007,24,40,2007/2008,12,40,8,32,-Inf
2006/2007,24,41,2007/2008,13,42,14,28,-Inf
2006/2007,24,42,2007/2008,14,36,12,24,-Inf
2006/2007,24,43,2007/2008,15,72,16,56,-Inf
2006/2007,24,44,2007/2008,16,75,10,65,-Inf
2006/2007,24,45,2007/2008,17,76,16,60,-Inf
2006/2007,24,46,2007/2008,18,92,18,74,-Inf
2006/2007,24,47,2007/2008,19,71,15,56,-Inf
2006/2007,24,48,2007/2008,20,112,23,89,-Inf
2006/2007,24,49,2007/2008,21,106,17,89,-Inf
2006/2007,24,50,2007/2008,22,101,33,68,-Inf
2006/2007,24,51,2007/2008,23,170,15,155,-Inf
2006/2007,24,52,2007/2008,24,135,13,122,-Inf
2006/2007,25,1,2006/2007,26,14,55,41,-Inf
2006/2007,25,2,2006/2007,27,17,53,36,-Inf
2006/2007,25,3,2006/2007,28,19,46,27,-Inf
2006/2007,25,4,2006/2007,29,20,43,23,-Inf
2006/2007,25,5,2006/2007,30,12,29,17,-Inf
2006/2007,25,6,2006/2007,31,21,22,1,-11.512925464970229
2006/2007,25,7,2006/2007,32,7,26,19,-Inf
2006/2007,25,8,2006/2007,33,19,13,6,-Inf
2006/2007,25,9,2006/2007,34,10,17,7,-Inf
2006/2007,25,10,2006/2007,35,13,8,5,-Inf
2006/2007,25,11,2006/2007,36,10,13,3,-10.819778284410283
2006/2007,25,12,2006/2007,37,8,10,2,-Inf
2006/2007,25,13,2006/2007,38,21,17,4,-Inf
2006/2007,25,14,2006/2007,39,11,19,8,-Inf
2006/2007,25,15,2006/2007,40,9,9,0,-0.4047103929772895
2006/2007,25,16,2006/2007,41,14,9,5,-Inf
2006/2007,25,17,2006/2007,42,14,9,5,-Inf
2006/2007,25,18,2006/2007,43,15,3,12,-Inf
2006/2007,25,19,2006/2007,44,18,7,11,-Inf
2006/2007,25,20,2006/2007,45,16,7,9,-Inf
2006/2007,25,21,2006/2007,46,12,0,12,-Inf
2006/2007,25,22,2006/2007,47,20,2,18,-Inf
2006/2007,25,23,2006/2007,48,8,3,5,-Inf
2006/2007,25,24,2006/2007,49,3,3,0,-0.3786430570649646
2006/2007,25,25,2006/2007,50,13,1,12,-Inf
2006/2007,25,26,2006/2007,51,4,3,1,-10.819778284410283
2006/2007,25,27,2006/2007,52,1,3,2,-Inf
2006/2007,25,28,2007/2008,1,10,3,7,-Inf
2006/2007,25,29,2007/2008,2,8,7,1,-10.819778284410283
2006/2007,25,30,2007/2008,3,13,3,10,-Inf
2006/2007,25,31,2007/2008,4,10,5,5,-Inf
2006/2007,25,32,2007/2008,5,21,11,10,-Inf
2006/2007,25,33,2007/2008,6,18,5,13,-Inf
2006/2007,25,34,2007/2008,7,21,5,16,-Inf
2006/2007,25,35,2007/2008,8,34,6,28,-Inf
2006/2007,25,36,2007/2008,9,25,6,19,-Inf
2006/2007,25,37,2007/2008,10,34,4,30,-Inf
2006/2007,25,38,2007/2008,11,33,4,29,-Inf
2006/2007,25,39,2007/2008,12,40,8,32,-Inf
2006/2007,25,40,2007/2008,13,42,14,28,-Inf
2006/2007,25,41,2007/2008,14,36,12,24,-Inf
2006/2007,25,42,2007/2008,15,72,16,56,-Inf
2006/2007,25,43,2007/2008,16,75,10,65,-Inf
2006/2007,25,44,2007/2008,17,76,16,60,-Inf
2006/2007,25,45,2007/2008,18,92,18,74,-Inf
2006/2007,25,46,2007/2008,19,71,15,56,-Inf
2006/2007,25,47,2007/2008,20,112,23,89,-Inf
2006/2007,25,48,2007/2008,21,106,17,89,-Inf
2006/2007,25,49,2007/2008,22,101,33,68,-Inf
2006/2007,25,50,2007/2008,23,170,15,155,-Inf
2006/2007,25,51,2007/2008,24,135,13,122,-Inf
2006/2007,25,52,2007/2008,25,106,11,95,-Inf
2006/2007,26,1,2006/2007,27,17,53,36,-Inf
2006/2007,26,2,2006/2007,28,19,46,27,-Inf
2006/2007,26,3,2006/2007,29,20,43,23,-Inf
2006/2007,26,4,2006/2007,30,12,29,17,-11.512925464970229
2006/2007,26,5,2006/2007,31,21,22,1,-10.819778284410283
2006/2007,26,6,2006/2007,32,7,26,19,-11.512925464970229
2006/2007,26,7,2006/2007,33,19,13,6,-Inf
2006/2007,26,8,2006/2007,34,10,17,7,-Inf
2006/2007,26,9,2006/2007,35,13,8,5,-Inf
2006/2007,26,10,2006/2007,36,10,13,3,-Inf
2006/2007,26,11,2006/2007,37,8,10,2,-10.819778284410283
2006/2007,26,12,2006/2007,38,21,17,4,-Inf
2006/2007,26,13,2006/2007,39,11,19,8,-Inf
2006/2007,26,14,2006/2007,40,9,9,0,-0.41013599975806336
2006/2007,26,15,2006/2007,41,14,9,5,-Inf
2006/2007,26,16,2006/2007,42,14,9,5,-Inf
2006/2007,26,17,2006/2007,43,15,3,12,-Inf
2006/2007,26,18,2006/2007,44,18,7,11,-Inf
2006/2007,26,19,2006/2007,45,16,7,9,-Inf
2006/2007,26,20,2006/2007,46,12,0,12,-Inf
2006/2007,26,21,2006/2007,47,20,2,18,-Inf
2006/2007,26,22,2006/2007,48,8,3,5,-Inf
2006/2007,26,23,2006/2007,49,3,3,0,-0.378205062489096
2006/2007,26,24,2006/2007,50,13,1,12,-Inf
2006/2007,26,25,2006/2007,51,4,3,1,-Inf
2006/2007,26,26,2006/2007,52,1,3,2,-11.512925464970229
2006/2007,26,27,2007/2008,1,10,3,7,-Inf
2006/2007,26,28,2007/2008,2,8,7,1,-10.819778284410283
2006/2007,26,29,2007/2008,3,13,3,10,-Inf
2006/2007,26,30,2007/2008,4,10,5,5,-Inf
2006/2007,26,31,2007/2008,5,21,11,10,-11.512925464970229
2006/2007,26,32,2007/2008,6,18,5,13,-Inf
2006/2007,26,33,2007/2008,7,21,5,16,-Inf
2006/2007,26,34,2007/2008,8,34,6,28,-Inf
2006/2007,26,35,2007/2008,9,25,6,19,-Inf
2006/2007,26,36,2007/2008,10,34,4,30,-Inf
2006/2007,26,37,2007/2008,11,33,4,29,-Inf
2006/2007,26,38,2007/2008,12,40,8,32,-Inf
2006/2007,26,39,2007/2008,13,42,14,28,-Inf
2006/2007,26,40,2007/2008,14,36,12,24,-Inf
2006/2007,26,41,2007/2008,15,72,16,56,-Inf
2006/2007,26,42,2007/2008,16,75,10,65,-Inf
2006/2007,26,43,2007/2008,17,76,16,60,-Inf
2006/2007,26,44,2007/2008,18,92,18,74,-Inf
2006/2007,26,45,2007/2008,19,71,15,56,-Inf
2006/2007,26,46,2007/2008,20,112,23,89,-Inf
2006/2007,26,47,2007/2008,21,106,17,89,-Inf
2006/2007,26,48,2007/2008,22,101,33,68,-Inf
2006/2007,26,49,2007/2008,23,170,15,155,-Inf
2006/2007,26,50,2007/2008,24,135,13,122,-Inf
2006/2007,26,51,2007/2008,25,106,11,95,-Inf
2006/2007,26,52,2007/2008,26,68,14,54,-Inf
2006/2007,27,1,2006/2007,28,19,46,27,-11.512925464970229
2006/2007,27,2,2006/2007,29,20,43,23,-Inf
2006/2007,27,3,2006/2007,30,12,29,17,-Inf
2006/2007,27,4,2006/2007,31,21,22,1,-10.41431317630212
2006/2007,27,5,2006/2007,32,7,26,19,-Inf
2006/2007,27,6,2006/2007,33,19,13,6,-Inf
2006/2007,27,7,2006/2007,34,10,17,7,-Inf
2006/2007,27,8,2006/2007,35,13,8,5,-Inf
2006/2007,27,9,2006/2007,36,10,13,3,-Inf
2006/2007,27,10,2006/2007,37,8,10,2,-11.512925464970229
2006/2007,27,11,2006/2007,38,21,17,4,-Inf
2006/2007,27,12,2006/2007,39,11,19,8,-Inf
2006/2007,27,13,2006/2007,40,9,9,0,-0.4172290325284074
2006/2007,27,14,2006/2007,41,14,9,5,-Inf
2006/2007,27,15,2006/2007,42,14,9,5,-Inf
2006/2007,27,16,2006/2007,43,15,3,12,-Inf
2006/2007,27,17,2006/2007,44,18,7,11,-Inf
2006/2007,27,18,2006/2007,45,16,7,9,-Inf
2006/2007,27,19,2006/2007,46,12,0,12,-Inf
2006/2007,27,20,2006/2007,47,20,2,18,-Inf
2006/2007,27,21,2006/2007,48,8,3,5,-Inf
2006/2007,27,22,2006/2007,49,3,3,0,-0.38152399733675857
2006/2007,27,23,2006/2007,50,13,1,12,-Inf
2006/2007,27,24,2006/2007,51,4,3,1,-Inf
2006/2007,27,25,2006/2007,52,1,3,2,-10.41431317630212
2006/2007,27,26,2007/2008,1,10,3,7,-Inf
2006/2007,27,27,2007/2008,2,8,7,1,-10.819778284410283
2006/2007,27,28,2007/2008,3,13,3,10,-Inf
2006/2007,27,29,2007/2008,4,10,5,5,-Inf
2006/2007,27,30,2007/2008,5,21,11,10,-Inf
2006/2007,27,31,2007/2008,6,18,5,13,-Inf
2006/2007,27,32,2007/2008,7,21,5,16,-Inf
2006/2007,27,33,2007/2008,8,34,6,28,-Inf
2006/2007,27,34,2007/2008,9,25,6,19,-Inf
2006/2007,27,35,2007/2008,10,34,4,30,-Inf
2006/2007,27,36,2007/2008,11,33,4,29,-Inf
2006/2007,27,37,2007/2008,12,40,8,32,-Inf
2006/2007,27,38,2007/2008,13,42,14,28,-Inf
2006/2007,27,39,2007/2008,14,36,12,24,-Inf
2006/2007,27,40,2007/2008,15,72,16,56,-Inf
2006/2007,27,41,2007/2008,16,75,10,65,-Inf
2006/2007,27,42,2007/2008,17,76,16,60,-Inf
2006/2007,27,43,2007/2008,18,92,18,74,-Inf
2006/2007,27,44,2007/2008,19,71,15,56,-Inf
2006/2007,27,45,2007/2008,20,112,23,89,-Inf
2006/2007,27,46,2007/2008,21,106,17,89,-Inf
2006/2007,27,47,2007/2008,22,101,33,68,-Inf
2006/2007,27,48,2007/2008,23,170,15,155,-Inf
2006/2007,27,49,2007/2008,24,135,13,122,-Inf
2006/2007,27,50,2007/2008,25,106,11,95,-Inf
2006/2007,27,51,2007/2008,26,68,14,54,-Inf
2006/2007,27,52,2007/2008,27,48,17,31,-Inf
2006/2007,28,1,2006/2007,29,20,43,23,-Inf
2006/2007,28,2,2006/2007,30,12,29,17,-11.512925464970229
2006/2007,28,3,2006/2007,31,21,22,1,-10.126631103850338
2006/2007,28,4,2006/2007,32,7,26,19,-Inf
2006/2007,28,5,2006/2007,33,19,13,6,-Inf
2006/2007,28,6,2006/2007,34,10,17,7,-Inf
2006/2007,28,7,2006/2007,35,13,8,5,-Inf
2006/2007,28,8,2006/2007,36,10,13,3,-Inf
2006/2007,28,9,2006/2007,37,8,10,2,-Inf
2006/2007,28,10,2006/2007,38,21,17,4,-Inf
2006/2007,28,11,2006/2007,39,11,19,8,-Inf
2006/2007,28,12,2006/2007,40,9,9,0,-0.42192991213941156
2006/2007,28,13,2006/2007,41,14,9,5,-Inf
2006/2007,28,14,2006/2007,42,14,9,5,-Inf
2006/2007,28,15,2006/2007,43,15,3,12,-Inf
2006/2007,28,16,2006/2007,44,18,7,11,-Inf
2006/2007,28,17,2006/2007,45,16,7,9,-Inf
2006/2007,28,18,2006/2007,46,12,0,12,-Inf
2006/2007,28,19,2006/2007,47,20,2,18,-Inf
2006/2007,28,20,2006/2007,48,8,3,5,-Inf
2006/2007,28,21,2006/2007,49,3,3,0,-0.3830629214197785
2006/2007,28,22,2006/2007,50,13,1,12,-Inf
2006/2007,28,23,2006/2007,51,4,3,1,-Inf
2006/2007,28,24,2006/2007,52,1,3,2,-10.819778284410283
2006/2007,28,25,2007/2008,1,10,3,7,-Inf
2006/2007,28,26,2007/2008,2,8,7,1,-10.819778284410283
2006/2007,28,27,2007/2008,3,13,3,10,-Inf
2006/2007,28,28,2007/2008,4,10,5,5,-Inf
2006/2007,28,29,2007/2008,5,21,11,10,-Inf
2006/2007,28,30,2007/2008,6,18,5,13,-Inf
2006/2007,28,31,2007/2008,7,21,5,16,-Inf
2006/2007,28,32,2007/2008,8,34,6,28,-Inf
2006/2007,28,33,2007/2008,9,25,6,19,-Inf
2006/2007,28,34,2007/2008,10,34,4,30,-Inf
2006/2007,28,35,2007/2008,11,33,4,29,-Inf
2006/2007,28,36,2007/2008,12,40,8,32,-Inf
2006/2007,28,37,2007/2008,13,42,14,28,-Inf
2006/2007,28,38,2007/2008,14,36,12,24,-Inf
2006/2007,28,39,2007/2008,15,72,16,56,-Inf
2006/2007,28,40,2007/2008,16,75,10,65,-Inf
2006/2007,28,41,2007/2008,17,76,16,60,-Inf
2006/2007,28,42,2007/2008,18,92,18,74,-Inf
2006/2007,28,43,2007/2008,19,71,15,56,-Inf
2006/2007,28,44,2007/2008,20,112,23,89,-Inf
2006/2007,28,45,2007/2008,21,106,17,89,-Inf
2006/2007,28,46,2007/2008,22,101,33,68,-Inf
2006/2007,28,47,2007/2008,23,170,15,155,-Inf
2006/2007,28,48,2007/2008,24,135,13,122,-Inf
2006/2007,28,49,2007/2008,25,106,11,95,-Inf
2006/2007,28,50,2007/2008,26,68,14,54,-Inf
2006/2007,28,51,2007/2008,27,48,17,31,-Inf
2006/2007,28,52,2007/2008,28,48,19,29,-Inf
2006/2007,29,1,2006/2007,30,12,29,17,-Inf
2006/2007,29,2,2006/2007,31,21,22,1,-11.512925464970229
2006/2007,29,3,2006/2007,32,7,26,19,-Inf
2006/2007,29,4,2006/2007,33,19,13,6,-11.512925464970229
2006/2007,29,5,2006/2007,34,10,17,7,-Inf
2006/2007,29,6,2006/2007,35,13,8,5,-Inf
2006/2007,29,7,2006/2007,36,10,13,3,-Inf
2006/2007,29,8,2006/2007,37,8,10,2,-11.512925464970229
2006/2007,29,9,2006/2007,38,21,17,4,-Inf
2006/2007,29,10,2006/2007,39,11,19,8,-Inf
2006/2007,29,11,2006/2007,40,9,9,0,-0.4292302759084432
2006/2007,29,12,2006/2007,41,14,9,5,-Inf
2006/2007,29,13,2006/2007,42,14,9,5,-Inf
2006/2007,29,14,2006/2007,43,15,3,12,-Inf
2006/2007,29,15,2006/2007,44,18,7,11,-Inf
2006/2007,29,16,2006/2007,45,16,7,9,-11.512925464970229
2006/2007,29,17,2006/2007,46,12,0,12,-Inf
2006/2007,29,18,2006/2007,47,20,2,18,-Inf
2006/2007,29,19,2006/2007,48,8,3,5,-Inf
2006/2007,29,20,2006/2007,49,3,3,0,-0.3830335864436858
2006/2007,29,21,2006/2007,50,13,1,12,-Inf
2006/2007,29,22,2006/2007,51,4,3,1,-11.512925464970229
2006/2007,29,23,2006/2007,52,1,3,2,-11.512925464970229
2006/2007,29,24,2007/2008,1,10,3,7,-Inf
2006/2007,29,25,2007/2008,2,8,7,1,-Inf
2006/2007,29,26,2007/2008,3,13,3,10,-Inf
2006/2007,29,27,2007/2008,4,10,5,5,-Inf
2006/2007,29,28,2007/2008,5,21,11,10,-Inf
2006/2007,29,29,2007/2008,6,18,5,13,-Inf
2006/2007,29,30,2007/2008,7,21,5,16,-Inf
2006/2007,29,31,2007/2008,8,34,6,28,-Inf
2006/2007,29,32,2007/2008,9,25,6,19,-Inf
2006/2007,29,33,2007/2008,10,34,4,30,-Inf
2006/2007,29,34,2007/2008,11,33,4,29,-Inf
2006/2007,29,35,2007/2008,12,40,8,32,-Inf
2006/2007,29,36,2007/2008,13,42,14,28,-Inf
2006/2007,29,37,2007/2008,14,36,12,24,-Inf
2006/2007,29,38,2007/2008,15,72,16,56,-Inf
2006/2007,29,39,2007/2008,16,75,10,65,-Inf
2006/2007,29,40,2007/2008,17,76,16,60,-Inf
2006/2007,29,41,2007/2008,18,92,18,74,-Inf
2006/2007,29,42,2007/2008,19,71,15,56,-Inf
2006/2007,29,43,2007/2008,20,112,23,89,-Inf
2006/2007,29,44,2007/2008,21,106,17,89,-Inf
2006/2007,29,45,2007/2008,22,101,33,68,-Inf
2006/2007,29,46,2007/2008,23,170,15,155,-Inf
2006/2007,29,47,2007/2008,24,135,13,122,-Inf
2006/2007,29,48,2007/2008,25,106,11,95,-Inf
2006/2007,29,49,2007/2008,26,68,14,54,-Inf
2006/2007,29,50,2007/2008,27,48,17,31,-Inf
2006/2007,29,51,2007/2008,28,48,19,29,-Inf
2006/2007,29,52,2007/2008,29,26,20,6,-11.512925464970229
2006/2007,2,1,2006/2007,3,3,6,3,-Inf
2006/2007,2,2,2006/2007,4,5,3,2,-Inf
2006/2007,2,3,2006/2007,5,11,4,7,-Inf
2006/2007,2,4,2006/2007,6,5,10,5,-Inf
2006/2007,2,5,2006/2007,7,5,12,7,-Inf
2006/2007,2,6,2006/2007,8,6,21,15,-Inf
2006/2007,2,7,2006/2007,9,6,26,20,-Inf
2006/2007,2,8,2006/2007,10,4,21,17,-Inf
2006/2007,2,9,2006/2007,11,4,30,26,-Inf
2006/2007,2,10,2006/2007,12,8,45,37,-Inf
2006/2007,2,11,2006/2007,13,14,56,42,-Inf
2006/2007,2,12,2006/2007,14,12,75,63,-Inf
2006/2007,2,13,2006/2007,15,16,83,67,-Inf
2006/2007,2,14,2006/2007,16,10,82,72,-Inf
2006/2007,2,15,2006/2007,17,16,126,110,-Inf
2006/2007,2,16,2006/2007,18,18,119,101,-Inf
2006/2007,2,17,2006/2007,19,15,137,122,-Inf
2006/2007,2,18,2006/2007,20,23,131,108,-Inf
2006/2007,2,19,2006/2007,21,17,112,95,-Inf
2006/2007,2,20,2006/2007,22,33,82,49,-Inf
2006/2007,2,21,2006/2007,23,15,73,58,-Inf
2006/2007,2,22,2006/2007,24,13,43,30,-Inf
2006/2007,2,23,2006/2007,25,11,55,44,-Inf
2006/2007,2,24,2006/2007,26,14,55,41,-Inf
2006/2007,2,25,2006/2007,27,17,53,36,-Inf
2006/2007,2,26,2006/2007,28,19,46,27,-Inf
2006/2007,2,27,2006/2007,29,20,43,23,-Inf
2006/2007,2,28,2006/2007,30,12,29,17,-Inf
2006/2007,2,29,2006/2007,31,21,22,1,-11.512925464970229
2006/2007,2,30,2006/2007,32,7,26,19,-Inf
2006/2007,2,31,2006/2007,33,19,13,6,-Inf
2006/2007,2,32,2006/2007,34,10,17,7,-Inf
2006/2007,2,33,2006/2007,35,13,8,5,-Inf
2006/2007,2,34,2006/2007,36,10,13,3,-Inf
2006/2007,2,35,2006/2007,37,8,10,2,-10.819778284410283
2006/2007,2,36,2006/2007,38,21,17,4,-Inf
2006/2007,2,37,2006/2007,39,11,19,8,-Inf
2006/2007,2,38,2006/2007,40,9,9,0,-0.3302834268721142
2006/2007,2,39,2006/2007,41,14,9,5,-Inf
2006/2007,2,40,2006/2007,42,14,9,5,-11.512925464970229
2006/2007,2,41,2006/2007,43,15,3,12,-Inf
2006/2007,2,42,2006/2007,44,18,7,11,-Inf
2006/2007,2,43,2006/2007,45,16,7,9,-11.512925464970229
2006/2007,2,44,2006/2007,46,12,0,12,-Inf
2006/2007,2,45,2006/2007,47,20,2,18,-Inf
2006/2007,2,46,2006/2007,48,8,3,5,-Inf
2006/2007,2,47,2006/2007,49,3,3,0,-0.34237763923790787
2006/2007,2,48,2006/2007,50,13,1,12,-Inf
2006/2007,2,49,2006/2007,51,4,3,1,-Inf
2006/2007,2,50,2006/2007,52,1,3,2,-11.512925464970229
2006/2007,2,51,2007/2008,1,10,3,7,-Inf
2006/2007,2,52,2007/2008,2,8,7,1,-Inf
2006/2007,30,1,2006/2007,31,21,22,1,-9.721165995742174
2006/2007,30,2,2006/2007,32,7,26,19,-11.512925464970229
2006/2007,30,3,2006/2007,33,19,13,6,-Inf
2006/2007,30,4,2006/2007,34,10,17,7,-10.819778284410283
2006/2007,30,5,2006/2007,35,13,8,5,-Inf
2006/2007,30,6,2006/2007,36,10,13,3,-Inf
2006/2007,30,7,2006/2007,37,8,10,2,-11.512925464970229
2006/2007,30,8,2006/2007,38,21,17,4,-Inf
2006/2007,30,9,2006/2007,39,11,19,8,-11.512925464970229
2006/2007,30,10,2006/2007,40,9,9,0,-0.43568723029775036
2006/2007,30,11,2006/2007,41,14,9,5,-Inf
2006/2007,30,12,2006/2007,42,14,9,5,-Inf
2006/2007,30,13,2006/2007,43,15,3,12,-Inf
2006/2007,30,14,2006/2007,44,18,7,11,-Inf
2006/2007,30,15,2006/2007,45,16,7,9,-Inf
2006/2007,30,16,2006/2007,46,12,0,12,-Inf
2006/2007,30,17,2006/2007,47,20,2,18,-Inf
2006/2007,30,18,2006/2007,48,8,3,5,-Inf
2006/2007,30,19,2006/2007,49,3,3,0,-0.38547132261328976
2006/2007,30,20,2006/2007,50,13,1,12,-Inf
2006/2007,30,21,2006/2007,51,4,3,1,-Inf
2006/2007,30,22,2006/2007,52,1,3,2,-11.512925464970229
2006/2007,30,23,2007/2008,1,10,3,7,-Inf
2006/2007,30,24,2007/2008,2,8,7,1,-Inf
2006/2007,30,25,2007/2008,3,13,3,10,-Inf
2006/2007,30,26,2007/2008,4,10,5,5,-11.512925464970229
2006/2007,30,27,2007/2008,5,21,11,10,-Inf
2006/2007,30,28,2007/2008,6,18,5,13,-Inf
2006/2007,30,29,2007/2008,7,21,5,16,-Inf
2006/2007,30,30,2007/2008,8,34,6,28,-Inf
2006/2007,30,31,2007/2008,9,25,6,19,-Inf
2006/2007,30,32,2007/2008,10,34,4,30,-Inf
2006/2007,30,33,2007/2008,11,33,4,29,-Inf
2006/2007,30,34,2007/2008,12,40,8,32,-Inf
2006/2007,30,35,2007/2008,13,42,14,28,-Inf
2006/2007,30,36,2007/2008,14,36,12,24,-Inf
2006/2007,30,37,2007/2008,15,72,16,56,-Inf
2006/2007,30,38,2007/2008,16,75,10,65,-Inf
2006/2007,30,39,2007/2008,17,76,16,60,-Inf
2006/2007,30,40,2007/2008,18,92,18,74,-Inf
2006/2007,30,41,2007/2008,19,71,15,56,-Inf
2006/2007,30,42,2007/2008,20,112,23,89,-Inf
2006/2007,30,43,2007/2008,21,106,17,89,-Inf
2006/2007,30,44,2007/2008,22,101,33,68,-Inf
2006/2007,30,45,2007/2008,23,170,15,155,-Inf
2006/2007,30,46,2007/2008,24,135,13,122,-Inf
2006/2007,30,47,2007/2008,25,106,11,95,-Inf
2006/2007,30,48,2007/2008,26,68,14,54,-Inf
2006/2007,30,49,2007/2008,27,48,17,31,-Inf
2006/2007,30,50,2007/2008,28,48,19,29,-Inf
2006/2007,30,51,2007/2008,29,26,20,6,-Inf
2006/2007,30,52,2007/2008,30,33,12,21,-Inf
2006/2007,31,1,2006/2007,32,7,26,19,-Inf
2006/2007,31,2,2006/2007,33,19,13,6,-Inf
2006/2007,31,3,2006/2007,34,10,17,7,-Inf
2006/2007,31,4,2006/2007,35,13,8,5,-Inf
2006/2007,31,5,2006/2007,36,10,13,3,-10.819778284410283
2006/2007,31,6,2006/2007,37,8,10,2,-10.819778284410283
2006/2007,31,7,2006/2007,38,21,17,4,-Inf
2006/2007,31,8,2006/2007,39,11,19,8,-Inf
2006/2007,31,9,2006/2007,40,9,9,0,-0.4482734491090259
2006/2007,31,10,2006/2007,41,14,9,5,-Inf
2006/2007,31,11,2006/2007,42,14,9,5,-Inf
2006/2007,31,12,2006/2007,43,15,3,12,-Inf
2006/2007,31,13,2006/2007,44,18,7,11,-Inf
2006/2007,31,14,2006/2007,45,16,7,9,-Inf
2006/2007,31,15,2006/2007,46,12,0,12,-Inf
2006/2007,31,16,2006/2007,47,20,2,18,-Inf
2006/2007,31,17,2006/2007,48,8,3,5,-Inf
2006/2007,31,18,2006/2007,49,3,3,0,-0.3908523957403194
2006/2007,31,19,2006/2007,50,13,1,12,-Inf
2006/2007,31,20,2006/2007,51,4,3,1,-Inf
2006/2007,31,21,2006/2007,52,1,3,2,-Inf
2006/2007,31,22,2007/2008,1,10,3,7,-Inf
2006/2007,31,23,2007/2008,2,8,7,1,-Inf
2006/2007,31,24,2007/2008,3,13,3,10,-Inf
2006/2007,31,25,2007/2008,4,10,5,5,-Inf
2006/2007,31,26,2007/2008,5,21,11,10,-Inf
2006/2007,31,27,2007/2008,6,18,5,13,-Inf
2006/2007,31,28,2007/2008,7,21,5,16,-Inf
2006/2007,31,29,2007/2008,8,34,6,28,-Inf
2006/2007,31,30,2007/2008,9,25,6,19,-Inf
2006/2007,31,31,2007/2008,10,34,4,30,-Inf
2006/2007,31,32,2007/2008,11,33,4,29,-Inf
2006/2007,31,33,2007/2008,12,40,8,32,-Inf
2006/2007,31,34,2007/2008,13,42,14,28,-Inf
2006/2007,31,35,2007/2008,14,36,12,24,-Inf
2006/2007,31,36,2007/2008,15,72,16,56,-Inf
2006/2007,31,37,2007/2008,16,75,10,65,-Inf
2006/2007,31,38,2007/2008,17,76,16,60,-Inf
2006/2007,31,39,2007/2008,18,92,18,74,-Inf
2006/2007,31,40,2007/2008,19,71,15,56,-Inf
2006/2007,31,41,2007/2008,20,112,23,89,-Inf
2006/2007,31,42,2007/2008,21,106,17,89,-Inf
2006/2007,31,43,2007/2008,22,101,33,68,-Inf
2006/2007,31,44,2007/2008,23,170,15,155,-Inf
2006/2007,31,45,2007/2008,24,135,13,122,-Inf
2006/2007,31,46,2007/2008,25,106,11,95,-Inf
2006/2007,31,47,2007/2008,26,68,14,54,-Inf
2006/2007,31,48,2007/2008,27,48,17,31,-Inf
2006/2007,31,49,2007/2008,28,48,19,29,-Inf
2006/2007,31,50,2007/2008,29,26,20,6,-Inf
2006/2007,31,51,2007/2008,30,33,12,21,-Inf
2006/2007,31,52,2007/2008,31,29,21,8,-11.512925464970229
2006/2007,32,1,2006/2007,33,19,13,6,-Inf
2006/2007,32,2,2006/2007,34,10,17,7,-Inf
2006/2007,32,3,2006/2007,35,13,8,5,-Inf
2006/2007,32,4,2006/2007,36,10,13,3,-10.819778284410283
2006/2007,32,5,2006/2007,37,8,10,2,-10.819778284410283
2006/2007,32,6,2006/2007,38,21,17,4,-Inf
2006/2007,32,7,2006/2007,39,11,19,8,-Inf
2006/2007,32,8,2006/2007,40,9,9,0,-0.45786954590275997
2006/2007,32,9,2006/2007,41,14,9,5,-Inf
2006/2007,32,10,2006/2007,42,14,9,5,-Inf
2006/2007,32,11,2006/2007,43,15,3,12,-Inf
2006/2007,32,12,2006/2007,44,18,7,11,-Inf
2006/2007,32,13,2006/2007,45,16,7,9,-Inf
2006/2007,32,14,2006/2007,46,12,0,12,-Inf
2006/2007,32,15,2006/2007,47,20,2,18,-Inf
2006/2007,32,16,2006/2007,48,8,3,5,-Inf
2006/2007,32,17,2006/2007,49,3,3,0,-0.3969018774476769
2006/2007,32,18,2006/2007,50,13,1,12,-Inf
2006/2007,32,19,2006/2007,51,4,3,1,-Inf
2006/2007,32,20,2006/2007,52,1,3,2,-Inf
2006/2007,32,21,2007/2008,1,10,3,7,-11.512925464970229
2006/2007,32,22,2007/2008,2,8,7,1,-Inf
2006/2007,32,23,2007/2008,3,13,3,10,-Inf
2006/2007,32,24,2007/2008,4,10,5,5,-Inf
2006/2007,32,25,2007/2008,5,21,11,10,-Inf
2006/2007,32,26,2007/2008,6,18,5,13,-Inf
2006/2007,32,27,2007/2008,7,21,5,16,-Inf
2006/2007,32,28,2007/2008,8,34,6,28,-Inf
2006/2007,32,29,2007/2008,9,25,6,19,-Inf
2006/2007,32,30,2007/2008,10,34,4,30,-Inf
2006/2007,32,31,2007/2008,11,33,4,29,-Inf
2006/2007,32,32,2007/2008,12,40,8,32,-Inf
2006/2007,32,33,2007/2008,13,42,14,28,-Inf
2006/2007,32,34,2007/2008,14,36,12,24,-Inf
2006/2007,32,35,2007/2008,15,72,16,56,-Inf
2006/2007,32,36,2007/2008,16,75,10,65,-Inf
2006/2007,32,37,2007/2008,17,76,16,60,-Inf
2006/2007,32,38,2007/2008,18,92,18,74,-Inf
2006/2007,32,39,2007/2008,19,71,15,56,-Inf
2006/2007,32,40,2007/2008,20,112,23,89,-Inf
2006/2007,32,41,2007/2008,21,106,17,89,-Inf
2006/2007,32,42,2007/2008,22,101,33,68,-Inf
2006/2007,32,43,2007/2008,23,170,15,155,-Inf
2006/2007,32,44,2007/2008,24,135,13,122,-Inf
2006/2007,32,45,2007/2008,25,106,11,95,-Inf
2006/2007,32,46,2007/2008,26,68,14,54,-Inf
2006/2007,32,47,2007/2008,27,48,17,31,-Inf
2006/2007,32,48,2007/2008,28,48,19,29,-Inf
2006/2007,32,49,2007/2008,29,26,20,6,-Inf
2006/2007,32,50,2007/2008,30,33,12,21,-Inf
2006/2007,32,51,2007/2008,31,29,21,8,-Inf
2006/2007,32,52,2007/2008,32,17,7,10,-Inf
2006/2007,33,1,2006/2007,34,10,17,7,-11.512925464970229
2006/2007,33,2,2006/2007,35,13,8,5,-Inf
2006/2007,33,3,2006/2007,36,10,13,3,-11.512925464970229
2006/2007,33,4,2006/2007,37,8,10,2,-Inf
2006/2007,33,5,2006/2007,38,21,17,4,-11.512925464970229
2006/2007,33,6,2006/2007,39,11,19,8,-10.819778284410283
2006/2007,33,7,2006/2007,40,9,9,0,-0.1942160162410289
2006/2007,33,8,2006/2007,41,14,9,5,-Inf
2006/2007,33,9,2006/2007,42,14,9,5,-Inf
2006/2007,33,10,2006/2007,43,15,3,12,-Inf
2006/2007,33,11,2006/2007,44,18,7,11,-Inf
2006/2007,33,12,2006/2007,45,16,7,9,-Inf
2006/2007,33,13,2006/2007,46,12,0,12,-11.512925464970229
2006/2007,33,14,2006/2007,47,20,2,18,-Inf
2006/2007,33,15,2006/2007,48,8,3,5,-11.512925464970229
2006/2007,33,16,2006/2007,49,3,3,0,-0.2634969056634269
2006/2007,33,17,2006/2007,50,13,1,12,-Inf
2006/2007,33,18,2006/2007,51,4,3,1,-11.512925464970229
2006/2007,33,19,2006/2007,52,1,3,2,-11.512925464970229
2006/2007,33,20,2007/2008,1,10,3,7,-Inf
2006/2007,33,21,2007/2008,2,8,7,1,-11.512925464970229
2006/2007,33,22,2007/2008,3,13,3,10,-Inf
2006/2007,33,23,2007/2008,4,10,5,5,-Inf
2006/2007,33,24,2007/2008,5,21,11,10,-Inf
2006/2007,33,25,2007/2008,6,18,5,13,-Inf
2006/2007,33,26,2007/2008,7,21,5,16,-Inf
2006/2007,33,27,2007/2008,8,34,6,28,-Inf
2006/2007,33,28,2007/2008,9,25,6,19,-Inf
2006/2007,33,29,2007/2008,10,34,4,30,-Inf
2006/2007,33,30,2007/2008,11,33,4,29,-Inf
2006/2007,33,31,2007/2008,12,40,8,32,-Inf
2006/2007,33,32,2007/2008,13,42,14,28,-Inf
2006/2007,33,33,2007/2008,14,36,12,24,-Inf
2006/2007,33,34,2007/2008,15,72,16,56,-Inf
2006/2007,33,35,2007/2008,16,75,10,65,-Inf
2006/2007,33,36,2007/2008,17,76,16,60,-Inf
2006/2007,33,37,2007/2008,18,92,18,74,-Inf
2006/2007,33,38,2007/2008,19,71,15,56,-Inf
2006/2007,33,39,2007/2008,20,112,23,89,-Inf
2006/2007,33,40,2007/2008,21,106,17,89,-Inf
2006/2007,33,41,2007/2008,22,101,33,68,-Inf
2006/2007,33,42,2007/2008,23,170,15,155,-Inf
2006/2007,33,43,2007/2008,24,135,13,122,-Inf
2006/2007,33,44,2007/2008,25,106,11,95,-Inf
2006/2007,33,45,2007/2008,26,68,14,54,-Inf
2006/2007,33,46,2007/2008,27,48,17,31,-Inf
2006/2007,33,47,2007/2008,28,48,19,29,-Inf
2006/2007,33,48,2007/2008,29,26,20,6,-Inf
2006/2007,33,49,2007/2008,30,33,12,21,-Inf
2006/2007,33,50,2007/2008,31,29,21,8,-Inf
2006/2007,33,51,2007/2008,32,17,7,10,-Inf
2006/2007,33,52,2007/2008,33,12,19,7,-Inf
2006/2007,34,1,2006/2007,35,13,8,5,-Inf
2006/2007,34,2,2006/2007,36,10,13,3,-11.512925464970229
2006/2007,34,3,2006/2007,37,8,10,2,-10.819778284410283
2006/2007,34,4,2006/2007,38,21,17,4,-Inf
2006/2007,34,5,2006/2007,39,11,19,8,-11.512925464970229
2006/2007,34,6,2006/2007,40,9,9,0,-0.2484741798935044
2006/2007,34,7,2006/2007,41,14,9,5,-Inf
2006/2007,34,8,2006/2007,42,14,9,5,-Inf
2006/2007,34,9,2006/2007,43,15,3,12,-Inf
2006/2007,34,10,2006/2007,44,18,7,11,-Inf
2006/2007,34,11,2006/2007,45,16,7,9,-Inf
2006/2007,34,12,2006/2007,46,12,0,12,-Inf
2006/2007,34,13,2006/2007,47,20,2,18,-Inf
2006/2007,34,14,2006/2007,48,8,3,5,-Inf
2006/2007,34,15,2006/2007,49,3,3,0,-0.29084707579493774
2006/2007,34,16,2006/2007,50,13,1,12,-Inf
2006/2007,34,17,2006/2007,51,4,3,1,-10.41431317630212
2006/2007,34,18,2006/2007,52,1,3,2,-Inf
2006/2007,34,19,2007/2008,1,10,3,7,-Inf
2006/2007,34,20,2007/2008,2,8,7,1,-Inf
2006/2007,34,21,2007/2008,3,13,3,10,-Inf
2006/2007,34,22,2007/2008,4,10,5,5,-Inf
2006/2007,34,23,2007/2008,5,21,11,10,-11.512925464970229
2006/2007,34,24,2007/2008,6,18,5,13,-Inf
2006/2007,34,25,2007/2008,7,21,5,16,-Inf
2006/2007,34,26,2007/2008,8,34,6,28,-Inf
2006/2007,34,27,2007/2008,9,25,6,19,-Inf
2006/2007,34,28,2007/2008,10,34,4,30,-Inf
2006/2007,34,29,2007/2008,11,33,4,29,-Inf
2006/2007,34,30,2007/2008,12,40,8,32,-Inf
2006/2007,34,31,2007/2008,13,42,14,28,-Inf
2006/2007,34,32,2007/2008,14,36,12,24,-Inf
2006/2007,34,33,2007/2008,15,72,16,56,-11.512925464970229
2006/2007,34,34,2007/2008,16,75,10,65,-Inf
2006/2007,34,35,2007/2008,17,76,16,60,-Inf
2006/2007,34,36,2007/2008,18,92,18,74,-Inf
2006/2007,34,37,2007/2008,19,71,15,56,-Inf
2006/2007,34,38,2007/2008,20,112,23,89,-Inf
2006/2007,34,39,2007/2008,21,106,17,89,-Inf
2006/2007,34,40,2007/2008,22,101,33,68,-Inf
2006/2007,34,41,2007/2008,23,170,15,155,-Inf
2006/2007,34,42,2007/2008,24,135,13,122,-11.512925464970229
2006/2007,34,43,2007/2008,25,106,11,95,-Inf
2006/2007,34,44,2007/2008,26,68,14,54,-Inf
2006/2007,34,45,2007/2008,27,48,17,31,-Inf
2006/2007,34,46,2007/2008,28,48,19,29,-Inf
2006/2007,34,47,2007/2008,29,26,20,6,-Inf
2006/2007,34,48,2007/2008,30,33,12,21,-Inf
2006/2007,34,49,2007/2008,31,29,21,8,-Inf
2006/2007,34,50,2007/2008,32,17,7,10,-Inf
2006/2007,34,51,2007/2008,33,12,19,7,-Inf
2006/2007,34,52,2007/2008,34,13,10,3,-Inf
2006/2007,35,1,2006/2007,36,10,13,3,-Inf
2006/2007,35,2,2006/2007,37,8,10,2,-Inf
2006/2007,35,3,2006/2007,38,21,17,4,-Inf
2006/2007,35,4,2006/2007,39,11,19,8,-Inf
2006/2007,35,5,2006/2007,40,9,9,0,-0.15275498759228157
2006/2007,35,6,2006/2007,41,14,9,5,-Inf
2006/2007,35,7,2006/2007,42,14,9,5,-Inf
2006/2007,35,8,2006/2007,43,15,3,12,-Inf
2006/2007,35,9,2006/2007,44,18,7,11,-Inf
2006/2007,35,10,2006/2007,45,16,7,9,-Inf
2006/2007,35,11,2006/2007,46,12,0,12,-Inf
2006/2007,35,12,2006/2007,47,20,2,18,-Inf
2006/2007,35,13,2006/2007,48,8,3,5,-Inf
2006/2007,35,14,2006/2007,49,3,3,0,-0.24399698050937602
2006/2007,35,15,2006/2007,50,13,1,12,-Inf
2006/2007,35,16,2006/2007,51,4,3,1,-Inf
2006/2007,35,17,2006/2007,52,1,3,2,-Inf
2006/2007,35,18,2007/2008,1,10,3,7,-Inf
2006/2007,35,19,2007/2008,2,8,7,1,-11.512925464970229
2006/2007,35,20,2007/2008,3,13,3,10,-Inf
2006/2007,35,21,2007/2008,4,10,5,5,-11.512925464970229
2006/2007,35,22,2007/2008,5,21,11,10,-Inf
2006/2007,35,23,2007/2008,6,18,5,13,-Inf
2006/2007,35,24,2007/2008,7,21,5,16,-Inf
2006/2007,35,25,2007/2008,8,34,6,28,-Inf
2006/2007,35,26,2007/2008,9,25,6,19,-Inf
2006/2007,35,27,2007/2008,10,34,4,30,-Inf
2006/2007,35,28,2007/2008,11,33,4,29,-Inf
2006/2007,35,29,2007/2008,12,40,8,32,-Inf
2006/2007,35,30,2007/2008,13,42,14,28,-Inf
2006/2007,35,31,2007/2008,14,36,12,24,-Inf
2006/2007,35,32,2007/2008,15,72,16,56,-Inf
2006/2007,35,33,2007/2008,16,75,10,65,-Inf
2006/2007,35,34,2007/2008,17,76,16,60,-Inf
2006/2007,35,35,2007/2008,18,92,18,74,-Inf
2006/2007,35,36,2007/2008,19,71,15,56,-Inf
2006/2007,35,37,2007/2008,20,112,23,89,-Inf
2006/2007,35,38,2007/2008,21,106,17,89,-Inf
2006/2007,35,39,2007/2008,22,101,33,68,-Inf
2006/2007,35,40,2007/2008,23,170,15,155,-Inf
2006/2007,35,41,2007/2008,24,135,13,122,-Inf
2006/2007,35,42,2007/2008,25,106,11,95,-Inf
2006/2007,35,43,2007/2008,26,68,14,54,-Inf
2006/2007,35,44,2007/2008,27,48,17,31,-Inf
2006/2007,35,45,2007/2008,28,48,19,29,-Inf
2006/2007,35,46,2007/2008,29,26,20,6,-Inf
2006/2007,35,47,2007/2008,30,33,12,21,-Inf
2006/2007,35,48,2007/2008,31,29,21,8,-Inf
2006/2007,35,49,2007/2008,32,17,7,10,-11.512925464970229
2006/2007,35,50,2007/2008,33,12,19,7,-Inf
2006/2007,35,51,2007/2008,34,13,10,3,-11.512925464970229
2006/2007,35,52,2007/2008,35,17,13,4,-Inf
2006/2007,36,1,2006/2007,37,8,10,2,-Inf
2006/2007,36,2,2006/2007,38,21,17,4,-Inf
2006/2007,36,3,2006/2007,39,11,19,8,-11.512925464970229
2006/2007,36,4,2006/2007,40,9,9,0,-0.1255745609081007
2006/2007,36,5,2006/2007,41,14,9,5,-Inf
2006/2007,36,6,2006/2007,42,14,9,5,-Inf
2006/2007,36,7,2006/2007,43,15,3,12,-Inf
2006/2007,36,8,2006/2007,44,18,7,11,-Inf
2006/2007,36,9,2006/2007,45,16,7,9,-Inf
2006/2007,36,10,2006/2007,46,12,0,12,-Inf
2006/2007,36,11,2006/2007,47,20,2,18,-Inf
2006/2007,36,12,2006/2007,48,8,3,5,-Inf
2006/2007,36,13,2006/2007,49,3,3,0,-0.24838443918000408
2006/2007,36,14,2006/2007,50,13,1,12,-Inf
2006/2007,36,15,2006/2007,51,4,3,1,-11.512925464970229
2006/2007,36,16,2006/2007,52,1,3,2,-11.512925464970229
2006/2007,36,17,2007/2008,1,10,3,7,-Inf
2006/2007,36,18,2007/2008,2,8,7,1,-11.512925464970229
2006/2007,36,19,2007/2008,3,13,3,10,-Inf
2006/2007,36,20,2007/2008,4,10,5,5,-Inf
2006/2007,36,21,2007/2008,5,21,11,10,-Inf
2006/2007,36,22,2007/2008,6,18,5,13,-Inf
2006/2007,36,23,2007/2008,7,21,5,16,-Inf
2006/2007,36,24,2007/2008,8,34,6,28,-Inf
2006/2007,36,25,2007/2008,9,25,6,19,-Inf
2006/2007,36,26,2007/2008,10,34,4,30,-Inf
2006/2007,36,27,2007/2008,11,33,4,29,-Inf
2006/2007,36,28,2007/2008,12,40,8,32,-Inf
2006/2007,36,29,2007/2008,13,42,14,28,-Inf
2006/2007,36,30,2007/2008,14,36,12,24,-Inf
2006/2007,36,31,2007/2008,15,72,16,56,-Inf
2006/2007,36,32,2007/2008,16,75,10,65,-Inf
2006/2007,36,33,2007/2008,17,76,16,60,-Inf
2006/2007,36,34,2007/2008,18,92,18,74,-Inf
2006/2007,36,35,2007/2008,19,71,15,56,-Inf
2006/2007,36,36,2007/2008,20,112,23,89,-Inf
2006/2007,36,37,2007/2008,21,106,17,89,-Inf
2006/2007,36,38,2007/2008,22,101,33,68,-Inf
2006/2007,36,39,2007/2008,23,170,15,155,-Inf
2006/2007,36,40,2007/2008,24,135,13,122,-Inf
2006/2007,36,41,2007/2008,25,106,11,95,-Inf
2006/2007,36,42,2007/2008,26,68,14,54,-Inf
2006/2007,36,43,2007/2008,27,48,17,31,-Inf
2006/2007,36,44,2007/2008,28,48,19,29,-Inf
2006/2007,36,45,2007/2008,29,26,20,6,-Inf
2006/2007,36,46,2007/2008,30,33,12,21,-11.512925464970229
2006/2007,36,47,2007/2008,31,29,21,8,-11.512925464970229
2006/2007,36,48,2007/2008,32,17,7,10,-Inf
2006/2007,36,49,2007/2008,33,12,19,7,-Inf
2006/2007,36,50,2007/2008,34,13,10,3,-Inf
2006/2007,36,51,2007/2008,35,17,13,4,-Inf
2006/2007,36,52,2007/2008,36,15,10,5,-Inf
2006/2007,37,1,2006/2007,38,21,17,4,-Inf
2006/2007,37,2,2006/2007,39,11,19,8,-Inf
2006/2007,37,3,2006/2007,40,9,9,0,-0.13706907140895552
2006/2007,37,4,2006/2007,41,14,9,5,-Inf
2006/2007,37,5,2006/2007,42,14,9,5,-Inf
2006/2007,37,6,2006/2007,43,15,3,12,-Inf
2006/2007,37,7,2006/2007,44,18,7,11,-Inf
2006/2007,37,8,2006/2007,45,16,7,9,-Inf
2006/2007,37,9,2006/2007,46,12,0,12,-Inf
2006/2007,37,10,2006/2007,47,20,2,18,-Inf
2006/2007,37,11,2006/2007,48,8,3,5,-11.512925464970229
2006/2007,37,12,2006/2007,49,3,3,0,-0.27342420070508133
2006/2007,37,13,2006/2007,50,13,1,12,-Inf
2006/2007,37,14,2006/2007,51,4,3,1,-Inf
2006/2007,37,15,2006/2007,52,1,3,2,-Inf
2006/2007,37,16,2007/2008,1,10,3,7,-Inf
2006/2007,37,17,2007/2008,2,8,7,1,-11.512925464970229
2006/2007,37,18,2007/2008,3,13,3,10,-Inf
2006/2007,37,19,2007/2008,4,10,5,5,-Inf
2006/2007,37,20,2007/2008,5,21,11,10,-Inf
2006/2007,37,21,2007/2008,6,18,5,13,-Inf
2006/2007,37,22,2007/2008,7,21,5,16,-Inf
2006/2007,37,23,2007/2008,8,34,6,28,-Inf
2006/2007,37,24,2007/2008,9,25,6,19,-Inf
2006/2007,37,25,2007/2008,10,34,4,30,-Inf
2006/2007,37,26,2007/2008,11,33,4,29,-Inf
2006/2007,37,27,2007/2008,12,40,8,32,-Inf
2006/2007,37,28,2007/2008,13,42,14,28,-Inf
2006/2007,37,29,2007/2008,14,36,12,24,-Inf
2006/2007,37,30,2007/2008,15,72,16,56,-Inf
2006/2007,37,31,2007/2008,16,75,10,65,-Inf
2006/2007,37,32,2007/2008,17,76,16,60,-Inf
2006/2007,37,33,2007/2008,18,92,18,74,-Inf
2006/2007,37,34,2007/2008,19,71,15,56,-Inf
2006/2007,37,35,2007/2008,20,112,23,89,-Inf
2006/2007,37,36,2007/2008,21,106,17,89,-Inf
2006/2007,37,37,2007/2008,22,101,33,68,-Inf
2006/2007,37,38,2007/2008,23,170,15,155,-Inf
2006/2007,37,39,2007/2008,24,135,13,122,-Inf
2006/2007,37,40,2007/2008,25,106,11,95,-Inf
2006/2007,37,41,2007/2008,26,68,14,54,-Inf
2006/2007,37,42,2007/2008,27,48,17,31,-Inf
2006/2007,37,43,2007/2008,28,48,19,29,-Inf
2006/2007,37,44,2007/2008,29,26,20,6,-Inf
2006/2007,37,45,2007/2008,30,33,12,21,-Inf
2006/2007,37,46,2007/2008,31,29,21,8,-11.512925464970229
2006/2007,37,47,2007/2008,32,17,7,10,-Inf
2006/2007,37,48,2007/2008,33,12,19,7,-Inf
2006/2007,37,49,2007/2008,34,13,10,3,-11.512925464970229
2006/2007,37,50,2007/2008,35,17,13,4,-Inf
2006/2007,37,51,2007/2008,36,15,10,5,-11.512925464970229
2006/2007,37,52,2007/2008,37,14,8,6,-Inf
2006/2007,38,1,2006/2007,39,11,19,8,-Inf
2006/2007,38,2,2006/2007,40,9,9,0,-0.09726007962395755
2006/2007,38,3,2006/2007,41,14,9,5,-Inf
2006/2007,38,4,2006/2007,42,14,9,5,-Inf
2006/2007,38,5,2006/2007,43,15,3,12,-Inf
2006/2007,38,6,2006/2007,44,18,7,11,-Inf
2006/2007,38,7,2006/2007,45,16,7,9,-Inf
2006/2007,38,8,2006/2007,46,12,0,12,-Inf
2006/2007,38,9,2006/2007,47,20,2,18,-Inf
2006/2007,38,10,2006/2007,48,8,3,5,-Inf
2006/2007,38,11,2006/2007,49,3,3,0,-0.21417142151600643
2006/2007,38,12,2006/2007,50,13,1,12,-Inf
2006/2007,38,13,2006/2007,51,4,3,1,-11.512925464970229
2006/2007,38,14,2006/2007,52,1,3,2,-11.512925464970229
2006/2007,38,15,2007/2008,1,10,3,7,-Inf
2006/2007,38,16,2007/2008,2,8,7,1,-11.512925464970229
2006/2007,38,17,2007/2008,3,13,3,10,-Inf
2006/2007,38,18,2007/2008,4,10,5,5,-Inf
2006/2007,38,19,2007/2008,5,21,11,10,-11.512925464970229
2006/2007,38,20,2007/2008,6,18,5,13,-Inf
2006/2007,38,21,2007/2008,7,21,5,16,-Inf
2006/2007,38,22,2007/2008,8,34,6,28,-Inf
2006/2007,38,23,2007/2008,9,25,6,19,-Inf
2006/2007,38,24,2007/2008,10,34,4,30,-Inf
2006/2007,38,25,2007/2008,11,33,4,29,-Inf
2006/2007,38,26,2007/2008,12,40,8,32,-Inf
2006/2007,38,27,2007/2008,13,42,14,28,-Inf
2006/2007,38,28,2007/2008,14,36,12,24,-Inf
2006/2007,38,29,2007/2008,15,72,16,56,-Inf
2006/2007,38,30,2007/2008,16,75,10,65,-Inf
2006/2007,38,31,2007/2008,17,76,16,60,-Inf
2006/2007,38,32,2007/2008,18,92,18,74,-Inf
2006/2007,38,33,2007/2008,19,71,15,56,-11.512925464970229
2006/2007,38,34,2007/2008,20,112,23,89,-Inf
2006/2007,38,35,2007/2008,21,106,17,89,-Inf
2006/2007,38,36,2007/2008,22,101,33,68,-Inf
2006/2007,38,37,2007/2008,23,170,15,155,-Inf
2006/2007,38,38,2007/2008,24,135,13,122,-Inf
2006/2007,38,39,2007/2008,25,106,11,95,-Inf
2006/2007,38,40,2007/2008,26,68,14,54,-Inf
2006/2007,38,41,2007/2008,27,48,17,31,-Inf
2006/2007,38,42,2007/2008,28,48,19,29,-Inf
2006/2007,38,43,2007/2008,29,26,20,6,-Inf
2006/2007,38,44,2007/2008,30,33,12,21,-Inf
2006/2007,38,45,2007/2008,31,29,21,8,-Inf
2006/2007,38,46,2007/2008,32,17,7,10,-11.512925464970229
2006/2007,38,47,2007/2008,33,12,19,7,-11.512925464970229
2006/2007,38,48,2007/2008,34,13,10,3,-Inf
2006/2007,38,49,2007/2008,35,17,13,4,-Inf
2006/2007,38,50,2007/2008,36,15,10,5,-Inf
2006/2007,38,51,2007/2008,37,14,8,6,-Inf
2006/2007,38,52,2007/2008,38,15,21,6,-Inf
2006/2007,39,1,2006/2007,40,9,9,0,-0.1077856762061078
2006/2007,39,2,2006/2007,41,14,9,5,-Inf
2006/2007,39,3,2006/2007,42,14,9,5,-11.512925464970229
2006/2007,39,4,2006/2007,43,15,3,12,-11.512925464970229
2006/2007,39,5,2006/2007,44,18,7,11,-Inf
2006/2007,39,6,2006/2007,45,16,7,9,-Inf
2006/2007,39,7,2006/2007,46,12,0,12,-Inf
2006/2007,39,8,2006/2007,47,20,2,18,-Inf
2006/2007,39,9,2006/2007,48,8,3,5,-11.512925464970229
2006/2007,39,10,2006/2007,49,3,3,0,-0.23662147180198545
2006/2007,39,11,2006/2007,50,13,1,12,-Inf
2006/2007,39,12,2006/2007,51,4,3,1,-Inf
2006/2007,39,13,2006/2007,52,1,3,2,-10.819778284410283
2006/2007,39,14,2007/2008,1,10,3,7,-Inf
2006/2007,39,15,2007/2008,2,8,7,1,-Inf
2006/2007,39,16,2007/2008,3,13,3,10,-Inf
2006/2007,39,17,2007/2008,4,10,5,5,-Inf
2006/2007,39,18,2007/2008,5,21,11,10,-Inf
2006/2007,39,19,2007/2008,6,18,5,13,-Inf
2006/2007,39,20,2007/2008,7,21,5,16,-Inf
2006/2007,39,21,2007/2008,8,34,6,28,-Inf
2006/2007,39,22,2007/2008,9,25,6,19,-Inf
2006/2007,39,23,2007/2008,10,34,4,30,-Inf
2006/2007,39,24,2007/2008,11,33,4,29,-Inf
2006/2007,39,25,2007/2008,12,40,8,32,-Inf
2006/2007,39,26,2007/2008,13,42,14,28,-Inf
2006/2007,39,27,2007/2008,14,36,12,24,-Inf
2006/2007,39,28,2007/2008,15,72,16,56,-Inf
2006/2007,39,29,2007/2008,16,75,10,65,-Inf
2006/2007,39,30,2007/2008,17,76,16,60,-Inf
2006/2007,39,31,2007/2008,18,92,18,74,-Inf
2006/2007,39,32,2007/2008,19,71,15,56,-Inf
2006/2007,39,33,2007/2008,20,112,23,89,-Inf
2006/2007,39,34,2007/2008,21,106,17,89,-Inf
2006/2007,39,35,2007/2008,22,101,33,68,-Inf
2006/2007,39,36,2007/2008,23,170,15,155,-Inf
2006/2007,39,37,2007/2008,24,135,13,122,-Inf
2006/2007,39,38,2007/2008,25,106,11,95,-Inf
2006/2007,39,39,2007/2008,26,68,14,54,-Inf
2006/2007,39,40,2007/2008,27,48,17,31,-Inf
2006/2007,39,41,2007/2008,28,48,19,29,-Inf
2006/2007,39,42,2007/2008,29,26,20,6,-Inf
2006/2007,39,43,2007/2008,30,33,12,21,-Inf
2006/2007,39,44,2007/2008,31,29,21,8,-Inf
2006/2007,39,45,2007/2008,32,17,7,10,-Inf
2006/2007,39,46,2007/2008,33,12,19,7,-Inf
2006/2007,39,47,2007/2008,34,13,10,3,-Inf
2006/2007,39,48,2007/2008,35,17,13,4,-Inf
2006/2007,39,49,2007/2008,36,15,10,5,-Inf
2006/2007,39,50,2007/2008,37,14,8,6,-11.512925464970229
2006/2007,39,51,2007/2008,38,15,21,6,-Inf
2006/2007,39,52,2007/2008,39,10,11,1,-11.512925464970229
2006/2007,3,1,2006/2007,4,5,3,2,-Inf
2006/2007,3,2,2006/2007,5,11,4,7,-Inf
2006/2007,3,3,2006/2007,6,5,10,5,-Inf
2006/2007,3,4,2006/2007,7,5,12,7,-Inf
2006/2007,3,5,2006/2007,8,6,21,15,-Inf
2006/2007,3,6,2006/2007,9,6,26,20,-Inf
2006/2007,3,7,2006/2007,10,4,21,17,-Inf
2006/2007,3,8,2006/2007,11,4,30,26,-Inf
2006/2007,3,9,2006/2007,12,8,45,37,-Inf
2006/2007,3,10,2006/2007,13,14,56,42,-Inf
2006/2007,3,11,2006/2007,14,12,75,63,-Inf
2006/2007,3,12,2006/2007,15,16,83,67,-Inf
2006/2007,3,13,2006/2007,16,10,82,72,-Inf
2006/2007,3,14,2006/2007,17,16,126,110,-Inf
2006/2007,3,15,2006/2007,18,18,119,101,-Inf
2006/2007,3,16,2006/2007,19,15,137,122,-Inf
2006/2007,3,17,2006/2007,20,23,131,108,-Inf
2006/2007,3,18,2006/2007,21,17,112,95,-Inf
2006/2007,3,19,2006/2007,22,33,82,49,-Inf
2006/2007,3,20,2006/2007,23,15,73,58,-Inf
2006/2007,3,21,2006/2007,24,13,43,30,-Inf
2006/2007,3,22,2006/2007,25,11,55,44,-Inf
2006/2007,3,23,2006/2007,26,14,55,41,-Inf
2006/2007,3,24,2006/2007,27,17,53,36,-Inf
2006/2007,3,25,2006/2007,28,19,46,27,-Inf
2006/2007,3,26,2006/2007,29,20,43,23,-Inf
2006/2007,3,27,2006/2007,30,12,29,17,-Inf
2006/2007,3,28,2006/2007,31,21,22,1,-10.819778284410283
2006/2007,3,29,2006/2007,32,7,26,19,-Inf
2006/2007,3,30,2006/2007,33,19,13,6,-11.512925464970229
2006/2007,3,31,2006/2007,34,10,17,7,-Inf
2006/2007,3,32,2006/2007,35,13,8,5,-Inf
2006/2007,3,33,2006/2007,36,10,13,3,-Inf
2006/2007,3,34,2006/2007,37,8,10,2,-Inf
2006/2007,3,35,2006/2007,38,21,17,4,-Inf
2006/2007,3,36,2006/2007,39,11,19,8,-Inf
2006/2007,3,37,2006/2007,40,9,9,0,-0.32683878765297436
2006/2007,3,38,2006/2007,41,14,9,5,-Inf
2006/2007,3,39,2006/2007,42,14,9,5,-Inf
2006/2007,3,40,2006/2007,43,15,3,12,-Inf
2006/2007,3,41,2006/2007,44,18,7,11,-Inf
2006/2007,3,42,2006/2007,45,16,7,9,-Inf
2006/2007,3,43,2006/2007,46,12,0,12,-Inf
2006/2007,3,44,2006/2007,47,20,2,18,-Inf
2006/2007,3,45,2006/2007,48,8,3,5,-Inf
2006/2007,3,46,2006/2007,49,3,3,0,-0.3394807576856689
2006/2007,3,47,2006/2007,50,13,1,12,-Inf
2006/2007,3,48,2006/2007,51,4,3,1,-11.512925464970229
2006/2007,3,49,2006/2007,52,1,3,2,-11.512925464970229
2006/2007,3,50,2007/2008,1,10,3,7,-11.512925464970229
2006/2007,3,51,2007/2008,2,8,7,1,-10.41431317630212
2006/2007,3,52,2007/2008,3,13,3,10,-Inf
2006/2007,40,1,2006/2007,41,14,9,5,-Inf
2006/2007,40,2,2006/2007,42,14,9,5,-Inf
2006/2007,40,3,2006/2007,43,15,3,12,-Inf
2006/2007,40,4,2006/2007,44,18,7,11,-Inf
2006/2007,40,5,2006/2007,45,16,7,9,-Inf
2006/2007,40,6,2006/2007,46,12,0,12,-11.512925464970229
2006/2007,40,7,2006/2007,47,20,2,18,-Inf
2006/2007,40,8,2006/2007,48,8,3,5,-Inf
2006/2007,40,9,2006/2007,49,3,3,0,-0.21372554033595215
2006/2007,40,10,2006/2007,50,13,1,12,-Inf
2006/2007,40,11,2006/2007,51,4,3,1,-11.512925464970229
2006/2007,40,12,2006/2007,52,1,3,2,-11.512925464970229
2006/2007,40,13,2007/2008,1,10,3,7,-Inf
2006/2007,40,14,2007/2008,2,8,7,1,-11.512925464970229
2006/2007,40,15,2007/2008,3,13,3,10,-Inf
2006/2007,40,16,2007/2008,4,10,5,5,-Inf
2006/2007,40,17,2007/2008,5,21,11,10,-Inf
2006/2007,40,18,2007/2008,6,18,5,13,-Inf
2006/2007,40,19,2007/2008,7,21,5,16,-Inf
2006/2007,40,20,2007/2008,8,34,6,28,-Inf
2006/2007,40,21,2007/2008,9,25,6,19,-Inf
2006/2007,40,22,2007/2008,10,34,4,30,-Inf
2006/2007,40,23,2007/2008,11,33,4,29,-Inf
2006/2007,40,24,2007/2008,12,40,8,32,-Inf
2006/2007,40,25,2007/2008,13,42,14,28,-Inf
2006/2007,40,26,2007/2008,14,36,12,24,-Inf
2006/2007,40,27,2007/2008,15,72,16,56,-Inf
2006/2007,40,28,2007/2008,16,75,10,65,-Inf
2006/2007,40,29,2007/2008,17,76,16,60,-Inf
2006/2007,40,30,2007/2008,18,92,18,74,-Inf
2006/2007,40,31,2007/2008,19,71,15,56,-Inf
2006/2007,40,32,2007/2008,20,112,23,89,-Inf
2006/2007,40,33,2007/2008,21,106,17,89,-Inf
2006/2007,40,34,2007/2008,22,101,33,68,-Inf
2006/2007,40,35,2007/2008,23,170,15,155,-Inf
2006/2007,40,36,2007/2008,24,135,13,122,-Inf
2006/2007,40,37,2007/2008,25,106,11,95,-Inf
2006/2007,40,38,2007/2008,26,68,14,54,-Inf
2006/2007,40,39,2007/2008,27,48,17,31,-Inf
2006/2007,40,40,2007/2008,28,48,19,29,-Inf
2006/2007,40,41,2007/2008,29,26,20,6,-Inf
2006/2007,40,42,2007/2008,30,33,12,21,-Inf
2006/2007,40,43,2007/2008,31,29,21,8,-Inf
2006/2007,40,44,2007/2008,32,17,7,10,-Inf
2006/2007,40,45,2007/2008,33,12,19,7,-Inf
2006/2007,40,46,2007/2008,34,13,10,3,-Inf
2006/2007,40,47,2007/2008,35,17,13,4,-Inf
2006/2007,40,48,2007/2008,36,15,10,5,-11.512925464970229
2006/2007,40,49,2007/2008,37,14,8,6,-Inf
2006/2007,40,50,2007/2008,38,15,21,6,-Inf
2006/2007,40,51,2007/2008,39,10,11,1,-11.512925464970229
2006/2007,40,52,2007/2008,40,9,9,0,-0.34306794053251544
2006/2007,41,1,2006/2007,42,14,9,5,-Inf
2006/2007,41,2,2006/2007,43,15,3,12,-Inf
2006/2007,41,3,2006/2007,44,18,7,11,-Inf
2006/2007,41,4,2006/2007,45,16,7,9,-Inf
2006/2007,41,5,2006/2007,46,12,0,12,-Inf
2006/2007,41,6,2006/2007,47,20,2,18,-Inf
2006/2007,41,7,2006/2007,48,8,3,5,-11.512925464970229
2006/2007,41,8,2006/2007,49,3,3,0,-0.19556486354581892
2006/2007,41,9,2006/2007,50,13,1,12,-Inf
2006/2007,41,10,2006/2007,51,4,3,1,-11.512925464970229
2006/2007,41,11,2006/2007,52,1,3,2,-10.41431317630212
2006/2007,41,12,2007/2008,1,10,3,7,-Inf
2006/2007,41,13,2007/2008,2,8,7,1,-11.512925464970229
2006/2007,41,14,2007/2008,3,13,3,10,-Inf
2006/2007,41,15,2007/2008,4,10,5,5,-Inf
2006/2007,41,16,2007/2008,5,21,11,10,-Inf
2006/2007,41,17,2007/2008,6,18,5,13,-Inf
2006/2007,41,18,2007/2008,7,21,5,16,-Inf
2006/2007,41,19,2007/2008,8,34,6,28,-Inf
2006/2007,41,20,2007/2008,9,25,6,19,-Inf
2006/2007,41,21,2007/2008,10,34,4,30,-Inf
2006/2007,41,22,2007/2008,11,33,4,29,-Inf
2006/2007,41,23,2007/2008,12,40,8,32,-Inf
2006/2007,41,24,2007/2008,13,42,14,28,-Inf
2006/2007,41,25,2007/2008,14,36,12,24,-Inf
2006/2007,41,26,2007/2008,15,72,16,56,-Inf
2006/2007,41,27,2007/2008,16,75,10,65,-Inf
2006/2007,41,28,2007/2008,17,76,16,60,-Inf
2006/2007,41,29,2007/2008,18,92,18,74,-Inf
2006/2007,41,30,2007/2008,19,71,15,56,-Inf
2006/2007,41,31,2007/2008,20,112,23,89,-Inf
2006/2007,41,32,2007/2008,21,106,17,89,-Inf
2006/2007,41,33,2007/2008,22,101,33,68,-Inf
2006/2007,41,34,2007/2008,23,170,15,155,-Inf
2006/2007,41,35,2007/2008,24,135,13,122,-Inf
2006/2007,41,36,2007/2008,25,106,11,95,-Inf
2006/2007,41,37,2007/2008,26,68,14,54,-Inf
2006/2007,41,38,2007/2008,27,48,17,31,-Inf
2006/2007,41,39,2007/2008,28,48,19,29,-Inf
2006/2007,41,40,2007/2008,29,26,20,6,-Inf
2006/2007,41,41,2007/2008,30,33,12,21,-Inf
2006/2007,41,42,2007/2008,31,29,21,8,-Inf
2006/2007,41,43,2007/2008,32,17,7,10,-Inf
2006/2007,41,44,2007/2008,33,12,19,7,-Inf
2006/2007,41,45,2007/2008,34,13,10,3,-11.512925464970229
2006/2007,41,46,2007/2008,35,17,13,4,-11.512925464970229
2006/2007,41,47,2007/2008,36,15,10,5,-Inf
2006/2007,41,48,2007/2008,37,14,8,6,-Inf
2006/2007,41,49,2007/2008,38,15,21,6,-11.512925464970229
2006/2007,41,50,2007/2008,39,10,11,1,-10.819778284410283
2006/2007,41,51,2007/2008,40,9,9,0,-0.34404080612116594
2006/2007,41,52,2007/2008,41,2,14,12,-Inf
2006/2007,42,1,2006/2007,43,15,3,12,-Inf
2006/2007,42,2,2006/2007,44,18,7,11,-Inf
2006/2007,42,3,2006/2007,45,16,7,9,-Inf
2006/2007,42,4,2006/2007,46,12,0,12,-11.512925464970229
2006/2007,42,5,2006/2007,47,20,2,18,-Inf
2006/2007,42,6,2006/2007,48,8,3,5,-Inf
2006/2007,42,7,2006/2007,49,3,3,0,-0.25466001853200204
2006/2007,42,8,2006/2007,50,13,1,12,-Inf
2006/2007,42,9,2006/2007,51,4,3,1,-10.819778284410283
2006/2007,42,10,2006/2007,52,1,3,2,-Inf
2006/2007,42,11,2007/2008,1,10,3,7,-11.512925464970229
2006/2007,42,12,2007/2008,2,8,7,1,-11.512925464970229
2006/2007,42,13,2007/2008,3,13,3,10,-Inf
2006/2007,42,14,2007/2008,4,10,5,5,-Inf
2006/2007,42,15,2007/2008,5,21,11,10,-Inf
2006/2007,42,16,2007/2008,6,18,5,13,-Inf
2006/2007,42,17,2007/2008,7,21,5,16,-11.512925464970229
2006/2007,42,18,2007/2008,8,34,6,28,-Inf
2006/2007,42,19,2007/2008,9,25,6,19,-Inf
2006/2007,42,20,2007/2008,10,34,4,30,-Inf
2006/2007,42,21,2007/2008,11,33,4,29,-Inf
2006/2007,42,22,2007/2008,12,40,8,32,-Inf
2006/2007,42,23,2007/2008,13,42,14,28,-Inf
2006/2007,42,24,2007/2008,14,36,12,24,-Inf
2006/2007,42,25,2007/2008,15,72,16,56,-Inf
2006/2007,42,26,2007/2008,16,75,10,65,-Inf
2006/2007,42,27,2007/2008,17,76,16,60,-Inf
2006/2007,42,28,2007/2008,18,92,18,74,-Inf
2006/2007,42,29,2007/2008,19,71,15,56,-Inf
2006/2007,42,30,2007/2008,20,112,23,89,-Inf
2006/2007,42,31,2007/2008,21,106,17,89,-Inf
2006/2007,42,32,2007/2008,22,101,33,68,-Inf
2006/2007,42,33,2007/2008,23,170,15,155,-Inf
2006/2007,42,34,2007/2008,24,135,13,122,-11.512925464970229
2006/2007,42,35,2007/2008,25,106,11,95,-Inf
2006/2007,42,36,2007/2008,26,68,14,54,-Inf
2006/2007,42,37,2007/2008,27,48,17,31,-Inf
2006/2007,42,38,2007/2008,28,48,19,29,-Inf
2006/2007,42,39,2007/2008,29,26,20,6,-Inf
2006/2007,42,40,2007/2008,30,33,12,21,-Inf
2006/2007,42,41,2007/2008,31,29,21,8,-Inf
2006/2007,42,42,2007/2008,32,17,7,10,-Inf
2006/2007,42,43,2007/2008,33,12,19,7,-Inf
2006/2007,42,44,2007/2008,34,13,10,3,-Inf
2006/2007,42,45,2007/2008,35,17,13,4,-Inf
2006/2007,42,46,2007/2008,36,15,10,5,-Inf
2006/2007,42,47,2007/2008,37,14,8,6,-Inf
2006/2007,42,48,2007/2008,38,15,21,6,-Inf
2006/2007,42,49,2007/2008,39,10,11,1,-Inf
2006/2007,42,50,2007/2008,40,9,9,0,-0.34738961491406606
2006/2007,42,51,2007/2008,41,2,14,12,-Inf
2006/2007,42,52,2007/2008,42,6,14,8,-Inf
2006/2007,43,1,2006/2007,44,18,7,11,-Inf
2006/2007,43,2,2006/2007,45,16,7,9,-Inf
2006/2007,43,3,2006/2007,46,12,0,12,-Inf
2006/2007,43,4,2006/2007,47,20,2,18,-Inf
2006/2007,43,5,2006/2007,48,8,3,5,-Inf
2006/2007,43,6,2006/2007,49,3,3,0,-0.3087559073901325
2006/2007,43,7,2006/2007,50,13,1,12,-11.512925464970229
2006/2007,43,8,2006/2007,51,4,3,1,-Inf
2006/2007,43,9,2006/2007,52,1,3,2,-Inf
2006/2007,43,10,2007/2008,1,10,3,7,-Inf
2006/2007,43,11,2007/2008,2,8,7,1,-10.126631103850338
2006/2007,43,12,2007/2008,3,13,3,10,-Inf
2006/2007,43,13,2007/2008,4,10,5,5,-11.512925464970229
2006/2007,43,14,2007/2008,5,21,11,10,-Inf
2006/2007,43,15,2007/2008,6,18,5,13,-Inf
2006/2007,43,16,2007/2008,7,21,5,16,-Inf
2006/2007,43,17,2007/2008,8,34,6,28,-Inf
2006/2007,43,18,2007/2008,9,25,6,19,-Inf
2006/2007,43,19,2007/2008,10,34,4,30,-Inf
2006/2007,43,20,2007/2008,11,33,4,29,-Inf
2006/2007,43,21,2007/2008,12,40,8,32,-Inf
2006/2007,43,22,2007/2008,13,42,14,28,-Inf
2006/2007,43,23,2007/2008,14,36,12,24,-Inf
2006/2007,43,24,2007/2008,15,72,16,56,-Inf
2006/2007,43,25,2007/2008,16,75,10,65,-Inf
2006/2007,43,26,2007/2008,17,76,16,60,-Inf
2006/2007,43,27,2007/2008,18,92,18,74,-Inf
2006/2007,43,28,2007/2008,19,71,15,56,-Inf
2006/2007,43,29,2007/2008,20,112,23,89,-Inf
2006/2007,43,30,2007/2008,21,106,17,89,-Inf
2006/2007,43,31,2007/2008,22,101,33,68,-Inf
2006/2007,43,32,2007/2008,23,170,15,155,-Inf
2006/2007,43,33,2007/2008,24,135,13,122,-Inf
2006/2007,43,34,2007/2008,25,106,11,95,-Inf
2006/2007,43,35,2007/2008,26,68,14,54,-Inf
2006/2007,43,36,2007/2008,27,48,17,31,-Inf
2006/2007,43,37,2007/2008,28,48,19,29,-Inf
2006/2007,43,38,2007/2008,29,26,20,6,-Inf
2006/2007,43,39,2007/2008,30,33,12,21,-Inf
2006/2007,43,40,2007/2008,31,29,21,8,-11.512925464970229
2006/2007,43,41,2007/2008,32,17,7,10,-Inf
2006/2007,43,42,2007/2008,33,12,19,7,-Inf
2006/2007,43,43,2007/2008,34,13,10,3,-Inf
2006/2007,43,44,2007/2008,35,17,13,4,-Inf
2006/2007,43,45,2007/2008,36,15,10,5,-Inf
2006/2007,43,46,2007/2008,37,14,8,6,-Inf
2006/2007,43,47,2007/2008,38,15,21,6,-Inf
2006/2007,43,48,2007/2008,39,10,11,1,-11.512925464970229
2006/2007,43,49,2007/2008,40,9,9,0,-0.3465124715156289
2006/2007,43,50,2007/2008,41,2,14,12,-Inf
2006/2007,43,51,2007/2008,42,6,14,8,-11.512925464970229
2006/2007,43,52,2007/2008,43,8,15,7,-Inf
2006/2007,44,1,2006/2007,45,16,7,9,-Inf
2006/2007,44,2,2006/2007,46,12,0,12,-Inf
2006/2007,44,3,2006/2007,47,20,2,18,-Inf
2006/2007,44,4,2006/2007,48,8,3,5,-Inf
2006/2007,44,5,2006/2007,49,3,3,0,-0.45282404696933476
2006/2007,44,6,2006/2007,50,13,1,12,-Inf
2006/2007,44,7,2006/2007,51,4,3,1,-10.819778284410283
2006/2007,44,8,2006/2007,52,1,3,2,-Inf
2006/2007,44,9,2007/2008,1,10,3,7,-Inf
2006/2007,44,10,2007/2008,2,8,7,1,-10.819778284410283
2006/2007,44,11,2007/2008,3,13,3,10,-Inf
2006/2007,44,12,2007/2008,4,10,5,5,-Inf
2006/2007,44,13,2007/2008,5,21,11,10,-Inf
2006/2007,44,14,2007/2008,6,18,5,13,-Inf
2006/2007,44,15,2007/2008,7,21,5,16,-Inf
2006/2007,44,16,2007/2008,8,34,6,28,-Inf
2006/2007,44,17,2007/2008,9,25,6,19,-Inf
2006/2007,44,18,2007/2008,10,34,4,30,-Inf
2006/2007,44,19,2007/2008,11,33,4,29,-Inf
2006/2007,44,20,2007/2008,12,40,8,32,-Inf
2006/2007,44,21,2007/2008,13,42,14,28,-Inf
2006/2007,44,22,2007/2008,14,36,12,24,-Inf
2006/2007,44,23,2007/2008,15,72,16,56,-Inf
2006/2007,44,24,2007/2008,16,75,10,65,-Inf
2006/2007,44,25,2007/2008,17,76,16,60,-Inf
2006/2007,44,26,2007/2008,18,92,18,74,-Inf
2006/2007,44,27,2007/2008,19,71,15,56,-Inf
2006/2007,44,28,2007/2008,20,112,23,89,-Inf
2006/2007,44,29,2007/2008,21,106,17,89,-Inf
2006/2007,44,30,2007/2008,22,101,33,68,-Inf
2006/2007,44,31,2007/2008,23,170,15,155,-Inf
2006/2007,44,32,2007/2008,24,135,13,122,-Inf
2006/2007,44,33,2007/2008,25,106,11,95,-Inf
2006/2007,44,34,2007/2008,26,68,14,54,-Inf
2006/2007,44,35,2007/2008,27,48,17,31,-Inf
2006/2007,44,36,2007/2008,28,48,19,29,-Inf
2006/2007,44,37,2007/2008,29,26,20,6,-11.512925464970229
2006/2007,44,38,2007/2008,30,33,12,21,-Inf
2006/2007,44,39,2007/2008,31,29,21,8,-Inf
2006/2007,44,40,2007/2008,32,17,7,10,-Inf
2006/2007,44,41,2007/2008,33,12,19,7,-Inf
2006/2007,44,42,2007/2008,34,13,10,3,-11.512925464970229
2006/2007,44,43,2007/2008,35,17,13,4,-11.512925464970229
2006/2007,44,44,2007/2008,36,15,10,5,-11.512925464970229
2006/2007,44,45,2007/2008,37,14,8,6,-Inf
2006/2007,44,46,2007/2008,38,15,21,6,-Inf
2006/2007,44,47,2007/2008,39,10,11,1,-11.512925464970229
2006/2007,44,48,2007/2008,40,9,9,0,-0.3513747292112921
2006/2007,44,49,2007/2008,41,2,14,12,-Inf
2006/2007,44,50,2007/2008,42,6,14,8,-Inf
2006/2007,44,51,2007/2008,43,8,15,7,-Inf
2006/2007,44,52,2007/2008,44,5,18,13,-Inf
2006/2007,45,1,2006/2007,46,12,0,12,-11.512925464970229
2006/2007,45,2,2006/2007,47,20,2,18,-Inf
2006/2007,45,3,2006/2007,48,8,3,5,-11.512925464970229
2006/2007,45,4,2006/2007,49,3,3,0,-0.5189922130990521
2006/2007,45,5,2006/2007,50,13,1,12,-Inf
2006/2007,45,6,2006/2007,51,4,3,1,-9.903487552536129
2006/2007,45,7,2006/2007,52,1,3,2,-Inf
2006/2007,45,8,2007/2008,1,10,3,7,-Inf
2006/2007,45,9,2007/2008,2,8,7,1,-10.41431317630212
2006/2007,45,10,2007/2008,3,13,3,10,-Inf
2006/2007,45,11,2007/2008,4,10,5,5,-11.512925464970229
2006/2007,45,12,2007/2008,5,21,11,10,-Inf
2006/2007,45,13,2007/2008,6,18,5,13,-Inf
2006/2007,45,14,2007/2008,7,21,5,16,-Inf
2006/2007,45,15,2007/2008,8,34,6,28,-Inf
2006/2007,45,16,2007/2008,9,25,6,19,-Inf
2006/2007,45,17,2007/2008,10,34,4,30,-Inf
2006/2007,45,18,2007/2008,11,33,4,29,-Inf
2006/2007,45,19,2007/2008,12,40,8,32,-Inf
2006/2007,45,20,2007/2008,13,42,14,28,-Inf
2006/2007,45,21,2007/2008,14,36,12,24,-11.512925464970229
2006/2007,45,22,2007/2008,15,72,16,56,-Inf
2006/2007,45,23,2007/2008,16,75,10,65,-Inf
2006/2007,45,24,2007/2008,17,76,16,60,-Inf
2006/2007,45,25,2007/2008,18,92,18,74,-Inf
2006/2007,45,26,2007/2008,19,71,15,56,-Inf
2006/2007,45,27,2007/2008,20,112,23,89,-Inf
2006/2007,45,28,2007/2008,21,106,17,89,-Inf
2006/2007,45,29,2007/2008,22,101,33,68,-Inf
2006/2007,45,30,2007/2008,23,170,15,155,-Inf
2006/2007,45,31,2007/2008,24,135,13,122,-Inf
2006/2007,45,32,2007/2008,25,106,11,95,-Inf
2006/2007,45,33,2007/2008,26,68,14,54,-Inf
2006/2007,45,34,2007/2008,27,48,17,31,-Inf
2006/2007,45,35,2007/2008,28,48,19,29,-Inf
2006/2007,45,36,2007/2008,29,26,20,6,-Inf
2006/2007,45,37,2007/2008,30,33,12,21,-Inf
2006/2007,45,38,2007/2008,31,29,21,8,-Inf
2006/2007,45,39,2007/2008,32,17,7,10,-Inf
2006/2007,45,40,2007/2008,33,12,19,7,-Inf
2006/2007,45,41,2007/2008,34,13,10,3,-Inf
2006/2007,45,42,2007/2008,35,17,13,4,-11.512925464970229
2006/2007,45,43,2007/2008,36,15,10,5,-Inf
2006/2007,45,44,2007/2008,37,14,8,6,-Inf
2006/2007,45,45,2007/2008,38,15,21,6,-Inf
2006/2007,45,46,2007/2008,39,10,11,1,-10.819778284410283
2006/2007,45,47,2007/2008,40,9,9,0,-0.3554043229481625
2006/2007,45,48,2007/2008,41,2,14,12,-Inf
2006/2007,45,49,2007/2008,42,6,14,8,-Inf
2006/2007,45,50,2007/2008,43,8,15,7,-Inf
2006/2007,45,51,2007/2008,44,5,18,13,-Inf
2006/2007,45,52,2007/2008,45,1,16,15,-Inf
2006/2007,46,1,2006/2007,47,20,2,18,-Inf
2006/2007,46,2,2006/2007,48,8,3,5,-Inf
2006/2007,46,3,2006/2007,49,3,3,0,-0.5372722737809745
2006/2007,46,4,2006/2007,50,13,1,12,-Inf
2006/2007,46,5,2006/2007,51,4,3,1,-11.512925464970229
2006/2007,46,6,2006/2007,52,1,3,2,-Inf
2006/2007,46,7,2007/2008,1,10,3,7,-10.819778284410283
2006/2007,46,8,2007/2008,2,8,7,1,-10.41431317630212
2006/2007,46,9,2007/2008,3,13,3,10,-Inf
2006/2007,46,10,2007/2008,4,10,5,5,-Inf
2006/2007,46,11,2007/2008,5,21,11,10,-Inf
2006/2007,46,12,2007/2008,6,18,5,13,-Inf
2006/2007,46,13,2007/2008,7,21,5,16,-Inf
2006/2007,46,14,2007/2008,8,34,6,28,-Inf
2006/2007,46,15,2007/2008,9,25,6,19,-Inf
2006/2007,46,16,2007/2008,10,34,4,30,-Inf
2006/2007,46,17,2007/2008,11,33,4,29,-Inf
2006/2007,46,18,2007/2008,12,40,8,32,-Inf
2006/2007,46,19,2007/2008,13,42,14,28,-Inf
2006/2007,46,20,2007/2008,14,36,12,24,-11.512925464970229
2006/2007,46,21,2007/2008,15,72,16,56,-Inf
2006/2007,46,22,2007/2008,16,75,10,65,-Inf
2006/2007,46,23,2007/2008,17,76,16,60,-Inf
2006/2007,46,24,2007/2008,18,92,18,74,-Inf
2006/2007,46,25,2007/2008,19,71,15,56,-Inf
2006/2007,46,26,2007/2008,20,112,23,89,-Inf
2006/2007,46,27,2007/2008,21,106,17,89,-Inf
2006/2007,46,28,2007/2008,22,101,33,68,-Inf
2006/2007,46,29,2007/2008,23,170,15,155,-Inf
2006/2007,46,30,2007/2008,24,135,13,122,-Inf
2006/2007,46,31,2007/2008,25,106,11,95,-Inf
2006/2007,46,32,2007/2008,26,68,14,54,-Inf
2006/2007,46,33,2007/2008,27,48,17,31,-Inf
2006/2007,46,34,2007/2008,28,48,19,29,-Inf
2006/2007,46,35,2007/2008,29,26,20,6,-Inf
2006/2007,46,36,2007/2008,30,33,12,21,-Inf
2006/2007,46,37,2007/2008,31,29,21,8,-Inf
2006/2007,46,38,2007/2008,32,17,7,10,-Inf
2006/2007,46,39,2007/2008,33,12,19,7,-Inf
2006/2007,46,40,2007/2008,34,13,10,3,-Inf
2006/2007,46,41,2007/2008,35,17,13,4,-Inf
2006/2007,46,42,2007/2008,36,15,10,5,-Inf
2006/2007,46,43,2007/2008,37,14,8,6,-Inf
2006/2007,46,44,2007/2008,38,15,21,6,-Inf
2006/2007,46,45,2007/2008,39,10,11,1,-Inf
2006/2007,46,46,2007/2008,40,9,9,0,-0.35747526410950137
2006/2007,46,47,2007/2008,41,2,14,12,-Inf
2006/2007,46,48,2007/2008,42,6,14,8,-Inf
2006/2007,46,49,2007/2008,43,8,15,7,-Inf
2006/2007,46,50,2007/2008,44,5,18,13,-Inf
2006/2007,46,51,2007/2008,45,1,16,15,-Inf
2006/2007,46,52,2007/2008,46,2,12,10,-Inf
2006/2007,47,1,2006/2007,48,8,3,5,-Inf
2006/2007,47,2,2006/2007,49,3,3,0,-0.5573932595823248
2006/2007,47,3,2006/2007,50,13,1,12,-Inf
2006/2007,47,4,2006/2007,51,4,3,1,-11.512925464970229
2006/2007,47,5,2006/2007,52,1,3,2,-Inf
2006/2007,47,6,2007/2008,1,10,3,7,-Inf
2006/2007,47,7,2007/2008,2,8,7,1,-10.41431317630212
2006/2007,47,8,2007/2008,3,13,3,10,-Inf
2006/2007,47,9,2007/2008,4,10,5,5,-11.512925464970229
2006/2007,47,10,2007/2008,5,21,11,10,-Inf
2006/2007,47,11,2007/2008,6,18,5,13,-Inf
2006/2007,47,12,2007/2008,7,21,5,16,-Inf
2006/2007,47,13,2007/2008,8,34,6,28,-Inf
2006/2007,47,14,2007/2008,9,25,6,19,-Inf
2006/2007,47,15,2007/2008,10,34,4,30,-Inf
2006/2007,47,16,2007/2008,11,33,4,29,-Inf
2006/2007,47,17,2007/2008,12,40,8,32,-Inf
2006/2007,47,18,2007/2008,13,42,14,28,-Inf
2006/2007,47,19,2007/2008,14,36,12,24,-Inf
2006/2007,47,20,2007/2008,15,72,16,56,-Inf
2006/2007,47,21,2007/2008,16,75,10,65,-Inf
2006/2007,47,22,2007/2008,17,76,16,60,-Inf
2006/2007,47,23,2007/2008,18,92,18,74,-Inf
2006/2007,47,24,2007/2008,19,71,15,56,-Inf
2006/2007,47,25,2007/2008,20,112,23,89,-Inf
2006/2007,47,26,2007/2008,21,106,17,89,-Inf
2006/2007,47,27,2007/2008,22,101,33,68,-Inf
2006/2007,47,28,2007/2008,23,170,15,155,-Inf
2006/2007,47,29,2007/2008,24,135,13,122,-Inf
2006/2007,47,30,2007/2008,25,106,11,95,-Inf
2006/2007,47,31,2007/2008,26,68,14,54,-Inf
2006/2007,47,32,2007/2008,27,48,17,31,-Inf
2006/2007,47,33,2007/2008,28,48,19,29,-Inf
2006/2007,47,34,2007/2008,29,26,20,6,-Inf
2006/2007,47,35,2007/2008,30,33,12,21,-11.512925464970229
2006/2007,47,36,2007/2008,31,29,21,8,-Inf
2006/2007,47,37,2007/2008,32,17,7,10,-Inf
2006/2007,47,38,2007/2008,33,12,19,7,-Inf
2006/2007,47,39,2007/2008,34,13,10,3,-Inf
2006/2007,47,40,2007/2008,35,17,13,4,-11.512925464970229
2006/2007,47,41,2007/2008,36,15,10,5,-11.512925464970229
2006/2007,47,42,2007/2008,37,14,8,6,-Inf
2006/2007,47,43,2007/2008,38,15,21,6,-Inf
2006/2007,47,44,2007/2008,39,10,11,1,-10.819778284410283
2006/2007,47,45,2007/2008,40,9,9,0,-0.35821899251129885
2006/2007,47,46,2007/2008,41,2,14,12,-11.512925464970229
2006/2007,47,47,2007/2008,42,6,14,8,-Inf
2006/2007,47,48,2007/2008,43,8,15,7,-Inf
2006/2007,47,49,2007/2008,44,5,18,13,-Inf
2006/2007,47,50,2007/2008,45,1,16,15,-Inf
2006/2007,47,51,2007/2008,46,2,12,10,-Inf
2006/2007,47,52,2007/2008,47,3,20,17,-11.512925464970229
2006/2007,48,1,2006/2007,49,3,3,0,-0.5868071447886187
2006/2007,48,2,2006/2007,50,13,1,12,-11.512925464970229
2006/2007,48,3,2006/2007,51,4,3,1,-10.819778284410283
2006/2007,48,4,2006/2007,52,1,3,2,-Inf
2006/2007,48,5,2007/2008,1,10,3,7,-11.512925464970229
2006/2007,48,6,2007/2008,2,8,7,1,-9.903487552536129
2006/2007,48,7,2007/2008,3,13,3,10,-Inf
2006/2007,48,8,2007/2008,4,10,5,5,-Inf
2006/2007,48,9,2007/2008,5,21,11,10,-11.512925464970229
2006/2007,48,10,2007/2008,6,18,5,13,-Inf
2006/2007,48,11,2007/2008,7,21,5,16,-Inf
2006/2007,48,12,2007/2008,8,34,6,28,-Inf
2006/2007,48,13,2007/2008,9,25,6,19,-11.512925464970229
2006/2007,48,14,2007/2008,10,34,4,30,-Inf
2006/2007,48,15,2007/2008,11,33,4,29,-Inf
2006/2007,48,16,2007/2008,12,40,8,32,-Inf
2006/2007,48,17,2007/2008,13,42,14,28,-Inf
2006/2007,48,18,2007/2008,14,36,12,24,-Inf
2006/2007,48,19,2007/2008,15,72,16,56,-Inf
2006/2007,48,20,2007/2008,16,75,10,65,-Inf
2006/2007,48,21,2007/2008,17,76,16,60,-Inf
2006/2007,48,22,2007/2008,18,92,18,74,-Inf
2006/2007,48,23,2007/2008,19,71,15,56,-Inf
2006/2007,48,24,2007/2008,20,112,23,89,-Inf
2006/2007,48,25,2007/2008,21,106,17,89,-Inf
2006/2007,48,26,2007/2008,22,101,33,68,-Inf
2006/2007,48,27,2007/2008,23,170,15,155,-Inf
2006/2007,48,28,2007/2008,24,135,13,122,-Inf
2006/2007,48,29,2007/2008,25,106,11,95,-Inf
2006/2007,48,30,2007/2008,26,68,14,54,-Inf
2006/2007,48,31,2007/2008,27,48,17,31,-Inf
2006/2007,48,32,2007/2008,28,48,19,29,-Inf
2006/2007,48,33,2007/2008,29,26,20,6,-Inf
2006/2007,48,34,2007/2008,30,33,12,21,-Inf
2006/2007,48,35,2007/2008,31,29,21,8,-Inf
2006/2007,48,36,2007/2008,32,17,7,10,-Inf
2006/2007,48,37,2007/2008,33,12,19,7,-Inf
2006/2007,48,38,2007/2008,34,13,10,3,-11.512925464970229
2006/2007,48,39,2007/2008,35,17,13,4,-Inf
2006/2007,48,40,2007/2008,36,15,10,5,-Inf
2006/2007,48,41,2007/2008,37,14,8,6,-Inf
2006/2007,48,42,2007/2008,38,15,21,6,-Inf
2006/2007,48,43,2007/2008,39,10,11,1,-11.512925464970229
2006/2007,48,44,2007/2008,40,9,9,0,-0.3546769412760593
2006/2007,48,45,2007/2008,41,2,14,12,-Inf
2006/2007,48,46,2007/2008,42,6,14,8,-Inf
2006/2007,48,47,2007/2008,43,8,15,7,-Inf
2006/2007,48,48,2007/2008,44,5,18,13,-Inf
2006/2007,48,49,2007/2008,45,1,16,15,-Inf
2006/2007,48,50,2007/2008,46,2,12,10,-Inf
2006/2007,48,51,2007/2008,47,3,20,17,-Inf
2006/2007,48,52,2007/2008,48,4,8,4,-11.512925464970229
2006/2007,49,1,2006/2007,50,13,1,12,-Inf
2006/2007,49,2,2006/2007,51,4,3,1,-10.41431317630212
2006/2007,49,3,2006/2007,52,1,3,2,-Inf
2006/2007,49,4,2007/2008,1,10,3,7,-Inf
2006/2007,49,5,2007/2008,2,8,7,1,-10.819778284410283
2006/2007,49,6,2007/2008,3,13,3,10,-Inf
2006/2007,49,7,2007/2008,4,10,5,5,-Inf
2006/2007,49,8,2007/2008,5,21,11,10,-Inf
2006/2007,49,9,2007/2008,6,18,5,13,-Inf
2006/2007,49,10,2007/2008,7,21,5,16,-Inf
2006/2007,49,11,2007/2008,8,34,6,28,-Inf
2006/2007,49,12,2007/2008,9,25,6,19,-Inf
2006/2007,49,13,2007/2008,10,34,4,30,-Inf
2006/2007,49,14,2007/2008,11,33,4,29,-Inf
2006/2007,49,15,2007/2008,12,40,8,32,-Inf
2006/2007,49,16,2007/2008,13,42,14,28,-Inf
2006/2007,49,17,2007/2008,14,36,12,24,-Inf
2006/2007,49,18,2007/2008,15,72,16,56,-Inf
2006/2007,49,19,2007/2008,16,75,10,65,-Inf
2006/2007,49,20,2007/2008,17,76,16,60,-Inf
2006/2007,49,21,2007/2008,18,92,18,74,-Inf
2006/2007,49,22,2007/2008,19,71,15,56,-Inf
2006/2007,49,23,2007/2008,20,112,23,89,-Inf
2006/2007,49,24,2007/2008,21,106,17,89,-Inf
2006/2007,49,25,2007/2008,22,101,33,68,-Inf
2006/2007,49,26,2007/2008,23,170,15,155,-Inf
2006/2007,49,27,2007/2008,24,135,13,122,-Inf
2006/2007,49,28,2007/2008,25,106,11,95,-Inf
2006/2007,49,29,2007/2008,26,68,14,54,-Inf
2006/2007,49,30,2007/2008,27,48,17,31,-Inf
2006/2007,49,31,2007/2008,28,48,19,29,-Inf
2006/2007,49,32,2007/2008,29,26,20,6,-Inf
2006/2007,49,33,2007/2008,30,33,12,21,-Inf
2006/2007,49,34,2007/2008,31,29,21,8,-11.512925464970229
2006/2007,49,35,2007/2008,32,17,7,10,-Inf
2006/2007,49,36,2007/2008,33,12,19,7,-11.512925464970229
2006/2007,49,37,2007/2008,34,13,10,3,-Inf
2006/2007,49,38,2007/2008,35,17,13,4,-Inf
2006/2007,49,39,2007/2008,36,15,10,5,-Inf
2006/2007,49,40,2007/2008,37,14,8,6,-Inf
2006/2007,49,41,2007/2008,38,15,21,6,-Inf
2006/2007,49,42,2007/2008,39,10,11,1,-Inf
2006/2007,49,43,2007/2008,40,9,9,0,-0.3419130108266746
2006/2007,49,44,2007/2008,41,2,14,12,-Inf
2006/2007,49,45,2007/2008,42,6,14,8,-11.512925464970229
2006/2007,49,46,2007/2008,43,8,15,7,-Inf
2006/2007,49,47,2007/2008,44,5,18,13,-Inf
2006/2007,49,48,2007/2008,45,1,16,15,-Inf
2006/2007,49,49,2007/2008,46,2,12,10,-11.512925464970229
2006/2007,49,50,2007/2008,47,3,20,17,-Inf
2006/2007,49,51,2007/2008,48,4,8,4,-Inf
2006/2007,49,52,2007/2008,49,3,3,0,-0.34666803759970755
2006/2007,4,1,2006/2007,5,11,4,7,-Inf
2006/2007,4,2,2006/2007,6,5,10,5,-Inf
2006/2007,4,3,2006/2007,7,5,12,7,-Inf
2006/2007,4,4,2006/2007,8,6,21,15,-Inf
2006/2007,4,5,2006/2007,9,6,26,20,-Inf
2006/2007,4,6,2006/2007,10,4,21,17,-Inf
2006/2007,4,7,2006/2007,11,4,30,26,-Inf
2006/2007,4,8,2006/2007,12,8,45,37,-Inf
2006/2007,4,9,2006/2007,13,14,56,42,-Inf
2006/2007,4,10,2006/2007,14,12,75,63,-Inf
2006/2007,4,11,2006/2007,15,16,83,67,-Inf
2006/2007,4,12,2006/2007,16,10,82,72,-Inf
2006/2007,4,13,2006/2007,17,16,126,110,-Inf
2006/2007,4,14,2006/2007,18,18,119,101,-Inf
2006/2007,4,15,2006/2007,19,15,137,122,-Inf
2006/2007,4,16,2006/2007,20,23,131,108,-Inf
2006/2007,4,17,2006/2007,21,17,112,95,-Inf
2006/2007,4,18,2006/2007,22,33,82,49,-Inf
2006/2007,4,19,2006/2007,23,15,73,58,-Inf
2006/2007,4,20,2006/2007,24,13,43,30,-Inf
2006/2007,4,21,2006/2007,25,11,55,44,-Inf
2006/2007,4,22,2006/2007,26,14,55,41,-Inf
2006/2007,4,23,2006/2007,27,17,53,36,-Inf
2006/2007,4,24,2006/2007,28,19,46,27,-Inf
2006/2007,4,25,2006/2007,29,20,43,23,-Inf
2006/2007,4,26,2006/2007,30,12,29,17,-Inf
2006/2007,4,27,2006/2007,31,21,22,1,-Inf
2006/2007,4,28,2006/2007,32,7,26,19,-Inf
2006/2007,4,29,2006/2007,33,19,13,6,-11.512925464970229
2006/2007,4,30,2006/2007,34,10,17,7,-Inf
2006/2007,4,31,2006/2007,35,13,8,5,-11.512925464970229
2006/2007,4,32,2006/2007,36,10,13,3,-Inf
2006/2007,4,33,2006/2007,37,8,10,2,-Inf
2006/2007,4,34,2006/2007,38,21,17,4,-Inf
2006/2007,4,35,2006/2007,39,11,19,8,-Inf
2006/2007,4,36,2006/2007,40,9,9,0,-0.32947676210882726
2006/2007,4,37,2006/2007,41,14,9,5,-Inf
2006/2007,4,38,2006/2007,42,14,9,5,-Inf
2006/2007,4,39,2006/2007,43,15,3,12,-Inf
2006/2007,4,40,2006/2007,44,18,7,11,-Inf
2006/2007,4,41,2006/2007,45,16,7,9,-Inf
2006/2007,4,42,2006/2007,46,12,0,12,-Inf
2006/2007,4,43,2006/2007,47,20,2,18,-Inf
2006/2007,4,44,2006/2007,48,8,3,5,-11.512925464970229
2006/2007,4,45,2006/2007,49,3,3,0,-0.34064693857585127
2006/2007,4,46,2006/2007,50,13,1,12,-11.512925464970229
2006/2007,4,47,2006/2007,51,4,3,1,-11.512925464970229
2006/2007,4,48,2006/2007,52,1,3,2,-11.512925464970229
2006/2007,4,49,2007/2008,1,10,3,7,-Inf
2006/2007,4,50,2007/2008,2,8,7,1,-11.512925464970229
2006/2007,4,51,2007/2008,3,13,3,10,-Inf
2006/2007,4,52,2007/2008,4,10,5,5,-Inf
2006/2007,50,1,2006/2007,51,4,3,1,-11.512925464970229
2006/2007,50,2,2006/2007,52,1,3,2,-Inf
2006/2007,50,3,2007/2008,1,10,3,7,-Inf
2006/2007,50,4,2007/2008,2,8,7,1,-10.819778284410283
2006/2007,50,5,2007/2008,3,13,3,10,-Inf
2006/2007,50,6,2007/2008,4,10,5,5,-Inf
2006/2007,50,7,2007/2008,5,21,11,10,-11.512925464970229
2006/2007,50,8,2007/2008,6,18,5,13,-Inf
2006/2007,50,9,2007/2008,7,21,5,16,-Inf
2006/2007,50,10,2007/2008,8,34,6,28,-Inf
2006/2007,50,11,2007/2008,9,25,6,19,-Inf
2006/2007,50,12,2007/2008,10,34,4,30,-Inf
2006/2007,50,13,2007/2008,11,33,4,29,-Inf
2006/2007,50,14,2007/2008,12,40,8,32,-Inf
2006/2007,50,15,2007/2008,13,42,14,28,-Inf
2006/2007,50,16,2007/2008,14,36,12,24,-Inf
2006/2007,50,17,2007/2008,15,72,16,56,-Inf
2006/2007,50,18,2007/2008,16,75,10,65,-Inf
2006/2007,50,19,2007/2008,17,76,16,60,-Inf
2006/2007,50,20,2007/2008,18,92,18,74,-Inf
2006/2007,50,21,2007/2008,19,71,15,56,-Inf
2006/2007,50,22,2007/2008,20,112,23,89,-Inf
2006/2007,50,23,2007/2008,21,106,17,89,-Inf
2006/2007,50,24,2007/2008,22,101,33,68,-Inf
2006/2007,50,25,2007/2008,23,170,15,155,-Inf
2006/2007,50,26,2007/2008,24,135,13,122,-Inf
2006/2007,50,27,2007/2008,25,106,11,95,-Inf
2006/2007,50,28,2007/2008,26,68,14,54,-Inf
2006/2007,50,29,2007/2008,27,48,17,31,-Inf
2006/2007,50,30,2007/2008,28,48,19,29,-Inf
2006/2007,50,31,2007/2008,29,26,20,6,-Inf
2006/2007,50,32,2007/2008,30,33,12,21,-Inf
2006/2007,50,33,2007/2008,31,29,21,8,-11.512925464970229
2006/2007,50,34,2007/2008,32,17,7,10,-Inf
2006/2007,50,35,2007/2008,33,12,19,7,-Inf
2006/2007,50,36,2007/2008,34,13,10,3,-Inf
2006/2007,50,37,2007/2008,35,17,13,4,-Inf
2006/2007,50,38,2007/2008,36,15,10,5,-11.512925464970229
2006/2007,50,39,2007/2008,37,14,8,6,-Inf
2006/2007,50,40,2007/2008,38,15,21,6,-Inf
2006/2007,50,41,2007/2008,39,10,11,1,-Inf
2006/2007,50,42,2007/2008,40,9,9,0,-0.34726223990062444
2006/2007,50,43,2007/2008,41,2,14,12,-Inf
2006/2007,50,44,2007/2008,42,6,14,8,-Inf
2006/2007,50,45,2007/2008,43,8,15,7,-11.512925464970229
2006/2007,50,46,2007/2008,44,5,18,13,-Inf
2006/2007,50,47,2007/2008,45,1,16,15,-Inf
2006/2007,50,48,2007/2008,46,2,12,10,-Inf
2006/2007,50,49,2007/2008,47,3,20,17,-Inf
2006/2007,50,50,2007/2008,48,4,8,4,-Inf
2006/2007,50,51,2007/2008,49,3,3,0,-0.34999728918549167
2006/2007,50,52,2007/2008,50,1,13,12,-Inf
2006/2007,51,1,2006/2007,52,1,3,2,-Inf
2006/2007,51,2,2007/2008,1,10,3,7,-Inf
2006/2007,51,3,2007/2008,2,8,7,1,-10.41431317630212
2006/2007,51,4,2007/2008,3,13,3,10,-Inf
2006/2007,51,5,2007/2008,4,10,5,5,-10.819778284410283
2006/2007,51,6,2007/2008,5,21,11,10,-Inf
2006/2007,51,7,2007/2008,6,18,5,13,-10.819778284410283
2006/2007,51,8,2007/2008,7,21,5,16,-Inf
2006/2007,51,9,2007/2008,8,34,6,28,-Inf
2006/2007,51,10,2007/2008,9,25,6,19,-Inf
2006/2007,51,11,2007/2008,10,34,4,30,-Inf
2006/2007,51,12,2007/2008,11,33,4,29,-Inf
2006/2007,51,13,2007/2008,12,40,8,32,-Inf
2006/2007,51,14,2007/2008,13,42,14,28,-Inf
2006/2007,51,15,2007/2008,14,36,12,24,-Inf
2006/2007,51,16,2007/2008,15,72,16,56,-Inf
2006/2007,51,17,2007/2008,16,75,10,65,-Inf
2006/2007,51,18,2007/2008,17,76,16,60,-Inf
2006/2007,51,19,2007/2008,18,92,18,74,-Inf
2006/2007,51,20,2007/2008,19,71,15,56,-Inf
2006/2007,51,21,2007/2008,20,112,23,89,-Inf
2006/2007,51,22,2007/2008,21,106,17,89,-Inf
2006/2007,51,23,2007/2008,22,101,33,68,-Inf
2006/2007,51,24,2007/2008,23,170,15,155,-Inf
2006/2007,51,25,2007/2008,24,135,13,122,-Inf
2006/2007,51,26,2007/2008,25,106,11,95,-Inf
2006/2007,51,27,2007/2008,26,68,14,54,-Inf
2006/2007,51,28,2007/2008,27,48,17,31,-Inf
2006/2007,51,29,2007/2008,28,48,19,29,-Inf
2006/2007,51,30,2007/2008,29,26,20,6,-Inf
2006/2007,51,31,2007/2008,30,33,12,21,-Inf
2006/2007,51,32,2007/2008,31,29,21,8,-Inf
2006/2007,51,33,2007/2008,32,17,7,10,-Inf
2006/2007,51,34,2007/2008,33,12,19,7,-Inf
2006/2007,51,35,2007/2008,34,13,10,3,-11.512925464970229
2006/2007,51,36,2007/2008,35,17,13,4,-11.512925464970229
2006/2007,51,37,2007/2008,36,15,10,5,-Inf
2006/2007,51,38,2007/2008,37,14,8,6,-Inf
2006/2007,51,39,2007/2008,38,15,21,6,-11.512925464970229
2006/2007,51,40,2007/2008,39,10,11,1,-10.819778284410283
2006/2007,51,41,2007/2008,40,9,9,0,-0.35079228078057767
2006/2007,51,42,2007/2008,41,2,14,12,-Inf
2006/2007,51,43,2007/2008,42,6,14,8,-11.512925464970229
2006/2007,51,44,2007/2008,43,8,15,7,-Inf
2006/2007,51,45,2007/2008,44,5,18,13,-11.512925464970229
2006/2007,51,46,2007/2008,45,1,16,15,-Inf
2006/2007,51,47,2007/2008,46,2,12,10,-Inf
2006/2007,51,48,2007/2008,47,3,20,17,-Inf
2006/2007,51,49,2007/2008,48,4,8,4,-11.512925464970229
2006/2007,51,50,2007/2008,49,3,3,0,-0.3515594788405423
2006/2007,51,51,2007/2008,50,1,13,12,-Inf
2006/2007,51,52,2007/2008,51,3,4,1,-11.512925464970229
2006/2007,52,1,2007/2008,1,10,3,7,-11.512925464970229
2006/2007,52,2,2007/2008,2,8,7,1,-11.512925464970229
2006/2007,52,3,2007/2008,3,13,3,10,-Inf
2006/2007,52,4,2007/2008,4,10,5,5,-Inf
2006/2007,52,5,2007/2008,5,21,11,10,-Inf
2006/2007,52,6,2007/2008,6,18,5,13,-Inf
2006/2007,52,7,2007/2008,7,21,5,16,-Inf
2006/2007,52,8,2007/2008,8,34,6,28,-Inf
2006/2007,52,9,2007/2008,9,25,6,19,-Inf
2006/2007,52,10,2007/2008,10,34,4,30,-Inf
2006/2007,52,11,2007/2008,11,33,4,29,-Inf
2006/2007,52,12,2007/2008,12,40,8,32,-Inf
2006/2007,52,13,2007/2008,13,42,14,28,-Inf
2006/2007,52,14,2007/2008,14,36,12,24,-Inf
2006/2007,52,15,2007/2008,15,72,16,56,-Inf
2006/2007,52,16,2007/2008,16,75,10,65,-Inf
2006/2007,52,17,2007/2008,17,76,16,60,-Inf
2006/2007,52,18,2007/2008,18,92,18,74,-Inf
2006/2007,52,19,2007/2008,19,71,15,56,-Inf
2006/2007,52,20,2007/2008,20,112,23,89,-Inf
2006/2007,52,21,2007/2008,21,106,17,89,-Inf
2006/2007,52,22,2007/2008,22,101,33,68,-Inf
2006/2007,52,23,2007/2008,23,170,15,155,-Inf
2006/2007,52,24,2007/2008,24,135,13,122,-Inf
2006/2007,52,25,2007/2008,25,106,11,95,-Inf
2006/2007,52,26,2007/2008,26,68,14,54,-Inf
2006/2007,52,27,2007/2008,27,48,17,31,-Inf
2006/2007,52,28,2007/2008,28,48,19,29,-Inf
2006/2007,52,29,2007/2008,29,26,20,6,-Inf
2006/2007,52,30,2007/2008,30,33,12,21,-Inf
2006/2007,52,31,2007/2008,31,29,21,8,-Inf
2006/2007,52,32,2007/2008,32,17,7,10,-Inf
2006/2007,52,33,2007/2008,33,12,19,7,-Inf
2006/2007,52,34,2007/2008,34,13,10,3,-Inf
2006/2007,52,35,2007/2008,35,17,13,4,-Inf
2006/2007,52,36,2007/2008,36,15,10,5,-Inf
2006/2007,52,37,2007/2008,37,14,8,6,-Inf
2006/2007,52,38,2007/2008,38,15,21,6,-Inf
2006/2007,52,39,2007/2008,39,10,11,1,-11.512925464970229
2006/2007,52,40,2007/2008,40,9,9,0,-0.33149464540843354
2006/2007,52,41,2007/2008,41,2,14,12,-Inf
2006/2007,52,42,2007/2008,42,6,14,8,-Inf
2006/2007,52,43,2007/2008,43,8,15,7,-Inf
2006/2007,52,44,2007/2008,44,5,18,13,-Inf
2006/2007,52,45,2007/2008,45,1,16,15,-Inf
2006/2007,52,46,2007/2008,46,2,12,10,-Inf
2006/2007,52,47,2007/2008,47,3,20,17,-Inf
2006/2007,52,48,2007/2008,48,4,8,4,-Inf
2006/2007,52,49,2007/2008,49,3,3,0,-0.3390315087661371
2006/2007,52,50,2007/2008,50,1,13,12,-Inf
2006/2007,52,51,2007/2008,51,3,4,1,-11.512925464970229
2006/2007,52,52,2007/2008,52,5,1,4,-Inf
2006/2007,5,1,2006/2007,6,5,10,5,-Inf
2006/2007,5,2,2006/2007,7,5,12,7,-Inf
2006/2007,5,3,2006/2007,8,6,21,15,-Inf
2006/2007,5,4,2006/2007,9,6,26,20,-Inf
2006/2007,5,5,2006/2007,10,4,21,17,-Inf
2006/2007,5,6,2006/2007,11,4,30,26,-11.512925464970229
2006/2007,5,7,2006/2007,12,8,45,37,-Inf
2006/2007,5,8,2006/2007,13,14,56,42,-Inf
2006/2007,5,9,2006/2007,14,12,75,63,-Inf
2006/2007,5,10,2006/2007,15,16,83,67,-Inf
2006/2007,5,11,2006/2007,16,10,82,72,-Inf
2006/2007,5,12,2006/2007,17,16,126,110,-Inf
2006/2007,5,13,2006/2007,18,18,119,101,-Inf
2006/2007,5,14,2006/2007,19,15,137,122,-Inf
2006/2007,5,15,2006/2007,20,23,131,108,-Inf
2006/2007,5,16,2006/2007,21,17,112,95,-Inf
2006/2007,5,17,2006/2007,22,33,82,49,-Inf
2006/2007,5,18,2006/2007,23,15,73,58,-Inf
2006/2007,5,19,2006/2007,24,13,43,30,-Inf
2006/2007,5,20,2006/2007,25,11,55,44,-Inf
2006/2007,5,21,2006/2007,26,14,55,41,-Inf
2006/2007,5,22,2006/2007,27,17,53,36,-Inf
2006/2007,5,23,2006/2007,28,19,46,27,-Inf
2006/2007,5,24,2006/2007,29,20,43,23,-Inf
2006/2007,5,25,2006/2007,30,12,29,17,-Inf
2006/2007,5,26,2006/2007,31,21,22,1,-Inf
2006/2007,5,27,2006/2007,32,7,26,19,-11.512925464970229
2006/2007,5,28,2006/2007,33,19,13,6,-Inf
2006/2007,5,29,2006/2007,34,10,17,7,-Inf
2006/2007,5,30,2006/2007,35,13,8,5,-Inf
2006/2007,5,31,2006/2007,36,10,13,3,-11.512925464970229
2006/2007,5,32,2006/2007,37,8,10,2,-11.512925464970229
2006/2007,5,33,2006/2007,38,21,17,4,-Inf
2006/2007,5,34,2006/2007,39,11,19,8,-Inf
2006/2007,5,35,2006/2007,40,9,9,0,-0.32855962407085926
2006/2007,5,36,2006/2007,41,14,9,5,-Inf
2006/2007,5,37,2006/2007,42,14,9,5,-Inf
2006/2007,5,38,2006/2007,43,15,3,12,-Inf
2006/2007,5,39,2006/2007,44,18,7,11,-Inf
2006/2007,5,40,2006/2007,45,16,7,9,-Inf
2006/2007,5,41,2006/2007,46,12,0,12,-Inf
2006/2007,5,42,2006/2007,47,20,2,18,-Inf
2006/2007,5,43,2006/2007,48,8,3,5,-Inf
2006/2007,5,44,2006/2007,49,3,3,0,-0.34008475391149595
2006/2007,5,45,2006/2007,50,13,1,12,-Inf
2006/2007,5,46,2006/2007,51,4,3,1,-11.512925464970229
2006/2007,5,47,2006/2007,52,1,3,2,-10.41431317630212
2006/2007,5,48,2007/2008,1,10,3,7,-11.512925464970229
2006/2007,5,49,2007/2008,2,8,7,1,-10.819778284410283
2006/2007,5,50,2007/2008,3,13,3,10,-Inf
2006/2007,5,51,2007/2008,4,10,5,5,-11.512925464970229
2006/2007,5,52,2007/2008,5,21,11,10,-Inf
2006/2007,6,1,2006/2007,7,5,12,7,-Inf
2006/2007,6,2,2006/2007,8,6,21,15,-Inf
2006/2007,6,3,2006/2007,9,6,26,20,-Inf
2006/2007,6,4,2006/2007,10,4,21,17,-Inf
2006/2007,6,5,2006/2007,11,4,30,26,-Inf
2006/2007,6,6,2006/2007,12,8,45,37,-Inf
2006/2007,6,7,2006/2007,13,14,56,42,-Inf
2006/2007,6,8,2006/2007,14,12,75,63,-Inf
2006/2007,6,9,2006/2007,15,16,83,67,-Inf
2006/2007,6,10,2006/2007,16,10,82,72,-Inf
2006/2007,6,11,2006/2007,17,16,126,110,-Inf
2006/2007,6,12,2006/2007,18,18,119,101,-Inf
2006/2007,6,13,2006/2007,19,15,137,122,-Inf
2006/2007,6,14,2006/2007,20,23,131,108,-Inf
2006/2007,6,15,2006/2007,21,17,112,95,-Inf
2006/2007,6,16,2006/2007,22,33,82,49,-Inf
2006/2007,6,17,2006/2007,23,15,73,58,-Inf
2006/2007,6,18,2006/2007,24,13,43,30,-Inf
2006/2007,6,19,2006/2007,25,11,55,44,-Inf
2006/2007,6,20,2006/2007,26,14,55,41,-Inf
2006/2007,6,21,2006/2007,27,17,53,36,-Inf
2006/2007,6,22,2006/2007,28,19,46,27,-Inf
2006/2007,6,23,2006/2007,29,20,43,23,-Inf
2006/2007,6,24,2006/2007,30,12,29,17,-Inf
2006/2007,6,25,2006/2007,31,21,22,1,-11.512925464970229
2006/2007,6,26,2006/2007,32,7,26,19,-Inf
2006/2007,6,27,2006/2007,33,19,13,6,-Inf
2006/2007,6,28,2006/2007,34,10,17,7,-Inf
2006/2007,6,29,2006/2007,35,13,8,5,-Inf
2006/2007,6,30,2006/2007,36,10,13,3,-Inf
2006/2007,6,31,2006/2007,37,8,10,2,-Inf
2006/2007,6,32,2006/2007,38,21,17,4,-Inf
2006/2007,6,33,2006/2007,39,11,19,8,-Inf
2006/2007,6,34,2006/2007,40,9,9,0,-0.32426307271478194
2006/2007,6,35,2006/2007,41,14,9,5,-11.512925464970229
2006/2007,6,36,2006/2007,42,14,9,5,-Inf
2006/2007,6,37,2006/2007,43,15,3,12,-11.512925464970229
2006/2007,6,38,2006/2007,44,18,7,11,-Inf
2006/2007,6,39,2006/2007,45,16,7,9,-Inf
2006/2007,6,40,2006/2007,46,12,0,12,-Inf
2006/2007,6,41,2006/2007,47,20,2,18,-Inf
2006/2007,6,42,2006/2007,48,8,3,5,-11.512925464970229
2006/2007,6,43,2006/2007,49,3,3,0,-0.3356265942775085
2006/2007,6,44,2006/2007,50,13,1,12,-Inf
2006/2007,6,45,2006/2007,51,4,3,1,-10.819778284410283
2006/2007,6,46,2006/2007,52,1,3,2,-11.512925464970229
2006/2007,6,47,2007/2008,1,10,3,7,-Inf
2006/2007,6,48,2007/2008,2,8,7,1,-Inf
2006/2007,6,49,2007/2008,3,13,3,10,-Inf
2006/2007,6,50,2007/2008,4,10,5,5,-Inf
2006/2007,6,51,2007/2008,5,21,11,10,-Inf
2006/2007,6,52,2007/2008,6,18,5,13,-Inf
2006/2007,7,1,2006/2007,8,6,21,15,-Inf
2006/2007,7,2,2006/2007,9,6,26,20,-Inf
2006/2007,7,3,2006/2007,10,4,21,17,-Inf
2006/2007,7,4,2006/2007,11,4,30,26,-Inf
2006/2007,7,5,2006/2007,12,8,45,37,-Inf
2006/2007,7,6,2006/2007,13,14,56,42,-Inf
2006/2007,7,7,2006/2007,14,12,75,63,-Inf
2006/2007,7,8,2006/2007,15,16,83,67,-Inf
2006/2007,7,9,2006/2007,16,10,82,72,-Inf
2006/2007,7,10,2006/2007,17,16,126,110,-Inf
2006/2007,7,11,2006/2007,18,18,119,101,-Inf
2006/2007,7,12,2006/2007,19,15,137,122,-Inf
2006/2007,7,13,2006/2007,20,23,131,108,-Inf
2006/2007,7,14,2006/2007,21,17,112,95,-Inf
2006/2007,7,15,2006/2007,22,33,82,49,-Inf
2006/2007,7,16,2006/2007,23,15,73,58,-Inf
2006/2007,7,17,2006/2007,24,13,43,30,-Inf
2006/2007,7,18,2006/2007,25,11,55,44,-Inf
2006/2007,7,19,2006/2007,26,14,55,41,-Inf
2006/2007,7,20,2006/2007,27,17,53,36,-Inf
2006/2007,7,21,2006/2007,28,19,46,27,-Inf
2006/2007,7,22,2006/2007,29,20,43,23,-Inf
2006/2007,7,23,2006/2007,30,12,29,17,-Inf
2006/2007,7,24,2006/2007,31,21,22,1,-Inf
2006/2007,7,25,2006/2007,32,7,26,19,-Inf
2006/2007,7,26,2006/2007,33,19,13,6,-Inf
2006/2007,7,27,2006/2007,34,10,17,7,-11.512925464970229
2006/2007,7,28,2006/2007,35,13,8,5,-Inf
2006/2007,7,29,2006/2007,36,10,13,3,-11.512925464970229
2006/2007,7,30,2006/2007,37,8,10,2,-Inf
2006/2007,7,31,2006/2007,38,21,17,4,-Inf
2006/2007,7,32,2006/2007,39,11,19,8,-Inf
2006/2007,7,33,2006/2007,40,9,9,0,-0.32713001141889286
2006/2007,7,34,2006/2007,41,14,9,5,-Inf
2006/2007,7,35,2006/2007,42,14,9,5,-Inf
2006/2007,7,36,2006/2007,43,15,3,12,-Inf
2006/2007,7,37,2006/2007,44,18,7,11,-Inf
2006/2007,7,38,2006/2007,45,16,7,9,-Inf
2006/2007,7,39,2006/2007,46,12,0,12,-Inf
2006/2007,7,40,2006/2007,47,20,2,18,-Inf
2006/2007,7,41,2006/2007,48,8,3,5,-11.512925464970229
2006/2007,7,42,2006/2007,49,3,3,0,-0.34057664820630507
2006/2007,7,43,2006/2007,50,13,1,12,-Inf
2006/2007,7,44,2006/2007,51,4,3,1,-Inf
2006/2007,7,45,2006/2007,52,1,3,2,-Inf
2006/2007,7,46,2007/2008,1,10,3,7,-Inf
2006/2007,7,47,2007/2008,2,8,7,1,-Inf
2006/2007,7,48,2007/2008,3,13,3,10,-Inf
2006/2007,7,49,2007/2008,4,10,5,5,-Inf
2006/2007,7,50,2007/2008,5,21,11,10,-Inf
2006/2007,7,51,2007/2008,6,18,5,13,-Inf
2006/2007,7,52,2007/2008,7,21,5,16,-Inf
2006/2007,8,1,2006/2007,9,6,26,20,-Inf
2006/2007,8,2,2006/2007,10,4,21,17,-Inf
2006/2007,8,3,2006/2007,11,4,30,26,-Inf
2006/2007,8,4,2006/2007,12,8,45,37,-Inf
2006/2007,8,5,2006/2007,13,14,56,42,-Inf
2006/2007,8,6,2006/2007,14,12,75,63,-Inf
2006/2007,8,7,2006/2007,15,16,83,67,-Inf
2006/2007,8,8,2006/2007,16,10,82,72,-Inf
2006/2007,8,9,2006/2007,17,16,126,110,-Inf
2006/2007,8,10,2006/2007,18,18,119,101,-Inf
2006/2007,8,11,2006/2007,19,15,137,122,-Inf
2006/2007,8,12,2006/2007,20,23,131,108,-Inf
2006/2007,8,13,2006/2007,21,17,112,95,-Inf
2006/2007,8,14,2006/2007,22,33,82,49,-Inf
2006/2007,8,15,2006/2007,23,15,73,58,-Inf
2006/2007,8,16,2006/2007,24,13,43,30,-Inf
2006/2007,8,17,2006/2007,25,11,55,44,-Inf
2006/2007,8,18,2006/2007,26,14,55,41,-Inf
2006/2007,8,19,2006/2007,27,17,53,36,-Inf
2006/2007,8,20,2006/2007,28,19,46,27,-Inf
2006/2007,8,21,2006/2007,29,20,43,23,-11.512925464970229
2006/2007,8,22,2006/2007,30,12,29,17,-Inf
2006/2007,8,23,2006/2007,31,21,22,1,-10.819778284410283
2006/2007,8,24,2006/2007,32,7,26,19,-11.512925464970229
2006/2007,8,25,2006/2007,33,19,13,6,-Inf
2006/2007,8,26,2006/2007,34,10,17,7,-Inf
2006/2007,8,27,2006/2007,35,13,8,5,-Inf
2006/2007,8,28,2006/2007,36,10,13,3,-10.819778284410283
2006/2007,8,29,2006/2007,37,8,10,2,-11.512925464970229
2006/2007,8,30,2006/2007,38,21,17,4,-Inf
2006/2007,8,31,2006/2007,39,11,19,8,-Inf
2006/2007,8,32,2006/2007,40,9,9,0,-0.3372645504189098
2006/2007,8,33,2006/2007,41,14,9,5,-Inf
2006/2007,8,34,2006/2007,42,14,9,5,-11.512925464970229
2006/2007,8,35,2006/2007,43,15,3,12,-Inf
2006/2007,8,36,2006/2007,44,18,7,11,-Inf
2006/2007,8,37,2006/2007,45,16,7,9,-10.819778284410283
2006/2007,8,38,2006/2007,46,12,0,12,-Inf
2006/2007,8,39,2006/2007,47,20,2,18,-Inf
2006/2007,8,40,2006/2007,48,8,3,5,-Inf
2006/2007,8,41,2006/2007,49,3,3,0,-0.3433216403224595
2006/2007,8,42,2006/2007,50,13,1,12,-Inf
2006/2007,8,43,2006/2007,51,4,3,1,-10.819778284410283
2006/2007,8,44,2006/2007,52,1,3,2,-10.41431317630212
2006/2007,8,45,2007/2008,1,10,3,7,-Inf
2006/2007,8,46,2007/2008,2,8,7,1,-Inf
2006/2007,8,47,2007/2008,3,13,3,10,-Inf
2006/2007,8,48,2007/2008,4,10,5,5,-Inf
2006/2007,8,49,2007/2008,5,21,11,10,-Inf
2006/2007,8,50,2007/2008,6,18,5,13,-11.512925464970229
2006/2007,8,51,2007/2008,7,21,5,16,-Inf
2006/2007,8,52,2007/2008,8,34,6,28,-Inf
2006/2007,9,1,2006/2007,10,4,21,17,-Inf
2006/2007,9,2,2006/2007,11,4,30,26,-Inf
2006/2007,9,3,2006/2007,12,8,45,37,-Inf
2006/2007,9,4,2006/2007,13,14,56,42,-Inf
2006/2007,9,5,2006/2007,14,12,75,63,-Inf
2006/2007,9,6,2006/2007,15,16,83,67,-Inf
2006/2007,9,7,2006/2007,16,10,82,72,-Inf
2006/2007,9,8,2006/2007,17,16,126,110,-Inf
2006/2007,9,9,2006/2007,18,18,119,101,-Inf
2006/2007,9,10,2006/2007,19,15,137,122,-Inf
2006/2007,9,11,2006/2007,20,23,131,108,-Inf
2006/2007,9,12,2006/2007,21,17,112,95,-Inf
2006/2007,9,13,2006/2007,22,33,82,49,-Inf
2006/2007,9,14,2006/2007,23,15,73,58,-Inf
2006/2007,9,15,2006/2007,24,13,43,30,-Inf
2006/2007,9,16,2006/2007,25,11,55,44,-Inf
2006/2007,9,17,2006/2007,26,14,55,41,-Inf
2006/2007,9,18,2006/2007,27,17,53,36,-Inf
2006/2007,9,19,2006/2007,28,19,46,27,-Inf
2006/2007,9,20,2006/2007,29,20,43,23,-Inf
2006/2007,9,21,2006/2007,30,12,29,17,-Inf
2006/2007,9,22,2006/2007,31,21,22,1,-11.512925464970229
2006/2007,9,23,2006/2007,32,7,26,19,-Inf
2006/2007,9,24,2006/2007,33,19,13,6,-Inf
2006/2007,9,25,2006/2007,34,10,17,7,-Inf
2006/2007,9,26,2006/2007,35,13,8,5,-Inf
2006/2007,9,27,2006/2007,36,10,13,3,-Inf
2006/2007,9,28,2006/2007,37,8,10,2,-11.512925464970229
2006/2007,9,29,2006/2007,38,21,17,4,-Inf
2006/2007,9,30,2006/2007,39,11,19,8,-Inf
2006/2007,9,31,2006/2007,40,9,9,0,-0.35067867185079216
2006/2007,9,32,2006/2007,41,14,9,5,-Inf
2006/2007,9,33,2006/2007,42,14,9,5,-Inf
2006/2007,9,34,2006/2007,43,15,3,12,-11.512925464970229
2006/2007,9,35,2006/2007,44,18,7,11,-Inf
2006/2007,9,36,2006/2007,45,16,7,9,-Inf
2006/2007,9,37,2006/2007,46,12,0,12,-Inf
2006/2007,9,38,2006/2007,47,20,2,18,-Inf
2006/2007,9,39,2006/2007,48,8,3,5,-11.512925464970229
2006/2007,9,40,2006/2007,49,3,3,0,-0.3475170061539661
2006/2007,9,41,2006/2007,50,13,1,12,-Inf
2006/2007,9,42,2006/2007,51,4,3,1,-Inf
2006/2007,9,43,2006/2007,52,1,3,2,-11.512925464970229
2006/2007,9,44,2007/2008,1,10,3,7,-Inf
2006/2007,9,45,2007/2008,2,8,7,1,-10.819778284410283
2006/2007,9,46,2007/2008,3,13,3,10,-Inf
2006/2007,9,47,2007/2008,4,10,5,5,-Inf
2006/2007,9,48,2007/2008,5,21,11,10,-Inf
2006/2007,9,49,2007/2008,6,18,5,13,-Inf
2006/2007,9,50,2007/2008,7,21,5,16,-Inf
2006/2007,9,51,2007/2008,8,34,6,28,-Inf
2006/2007,9,52,2007/2008,9,25,6,19,-Inf
2007/2008,10,1,2007/2008,11,33,4,29,-Inf
2007/2008,10,2,2007/2008,12,40,8,32,-Inf
2007/2008,10,3,2007/2008,13,42,14,28,-Inf
2007/2008,10,4,2007/2008,14,36,12,24,-Inf
2007/2008,10,5,2007/2008,15,72,16,56,-Inf
2007/2008,10,6,2007/2008,16,75,10,65,-Inf
2007/2008,10,7,2007/2008,17,76,16,60,-Inf
2007/2008,10,8,2007/2008,18,92,18,74,-Inf
2007/2008,10,9,2007/2008,19,71,15,56,-Inf
2007/2008,10,10,2007/2008,20,112,23,89,-Inf
2007/2008,10,11,2007/2008,21,106,17,89,-Inf
2007/2008,10,12,2007/2008,22,101,33,68,-Inf
2007/2008,10,13,2007/2008,23,170,15,155,-Inf
2007/2008,10,14,2007/2008,24,135,13,122,-Inf
2007/2008,10,15,2007/2008,25,106,11,95,-Inf
2007/2008,10,16,2007/2008,26,68,14,54,-Inf
2007/2008,10,17,2007/2008,27,48,17,31,-Inf
2007/2008,10,18,2007/2008,28,48,19,29,-Inf
2007/2008,10,19,2007/2008,29,26,20,6,-Inf
2007/2008,10,20,2007/2008,30,33,12,21,-Inf
2007/2008,10,21,2007/2008,31,29,21,8,-Inf
2007/2008,10,22,2007/2008,32,17,7,10,-Inf
2007/2008,10,23,2007/2008,33,12,19,7,-Inf
2007/2008,10,24,2007/2008,34,13,10,3,-Inf
2007/2008,10,25,2007/2008,35,17,13,4,-Inf
2007/2008,10,26,2007/2008,36,15,10,5,-Inf
2007/2008,10,27,2007/2008,37,14,8,6,-Inf
2007/2008,10,28,2007/2008,38,15,21,6,-Inf
2007/2008,10,29,2007/2008,39,10,11,1,-Inf
2007/2008,10,30,2007/2008,40,9,9,0,-0.364563116787739
2007/2008,10,31,2007/2008,41,2,14,12,-Inf
2007/2008,10,32,2007/2008,42,6,14,8,-Inf
2007/2008,10,33,2007/2008,43,8,15,7,-Inf
2007/2008,10,34,2007/2008,44,5,18,13,-Inf
2007/2008,10,35,2007/2008,45,1,16,15,-Inf
2007/2008,10,36,2007/2008,46,2,12,10,-Inf
2007/2008,10,37,2007/2008,47,3,20,17,-Inf
2007/2008,10,38,2007/2008,48,4,8,4,-Inf
2007/2008,10,39,2007/2008,49,3,3,0,-0.35548993205702395
2007/2008,10,40,2007/2008,50,1,13,12,-Inf
2007/2008,10,41,2007/2008,51,3,4,1,-11.512925464970229
2007/2008,10,42,2007/2008,52,5,1,4,-Inf
2007/2008,10,43,2008/2009,1,2,10,8,-Inf
2007/2008,10,44,2008/2009,2,3,8,5,-Inf
2007/2008,10,45,2008/2009,3,2,13,11,-Inf
2007/2008,10,46,2008/2009,4,3,10,7,-Inf
2007/2008,10,47,2008/2009,5,2,21,19,-Inf
2007/2008,10,48,2008/2009,6,2,18,16,-Inf
2007/2008,10,49,2008/2009,7,3,21,18,-Inf
2007/2008,10,50,2008/2009,8,4,34,30,-Inf
2007/2008,10,51,2008/2009,9,3,25,22,-Inf
2007/2008,10,52,2008/2009,10,4,34,30,-Inf
2007/2008,11,1,2007/2008,12,40,8,32,-Inf
2007/2008,11,2,2007/2008,13,42,14,28,-Inf
2007/2008,11,3,2007/2008,14,36,12,24,-Inf
2007/2008,11,4,2007/2008,15,72,16,56,-Inf
2007/2008,11,5,2007/2008,16,75,10,65,-Inf
2007/2008,11,6,2007/2008,17,76,16,60,-Inf
2007/2008,11,7,2007/2008,18,92,18,74,-Inf
2007/2008,11,8,2007/2008,19,71,15,56,-Inf
2007/2008,11,9,2007/2008,20,112,23,89,-Inf
2007/2008,11,10,2007/2008,21,106,17,89,-Inf
2007/2008,11,11,2007/2008,22,101,33,68,-Inf
2007/2008,11,12,2007/2008,23,170,15,155,-Inf
2007/2008,11,13,2007/2008,24,135,13,122,-Inf
2007/2008,11,14,2007/2008,25,106,11,95,-Inf
2007/2008,11,15,2007/2008,26,68,14,54,-Inf
2007/2008,11,16,2007/2008,27,48,17,31,-Inf
2007/2008,11,17,2007/2008,28,48,19,29,-Inf
2007/2008,11,18,2007/2008,29,26,20,6,-Inf
2007/2008,11,19,2007/2008,30,33,12,21,-Inf
2007/2008,11,20,2007/2008,31,29,21,8,-Inf
2007/2008,11,21,2007/2008,32,17,7,10,-Inf
2007/2008,11,22,2007/2008,33,12,19,7,-Inf
2007/2008,11,23,2007/2008,34,13,10,3,-Inf
2007/2008,11,24,2007/2008,35,17,13,4,-11.512925464970229
2007/2008,11,25,2007/2008,36,15,10,5,-Inf
2007/2008,11,26,2007/2008,37,14,8,6,-Inf
2007/2008,11,27,2007/2008,38,15,21,6,-Inf
2007/2008,11,28,2007/2008,39,10,11,1,-10.819778284410283
2007/2008,11,29,2007/2008,40,9,9,0,-0.36457751573949615
2007/2008,11,30,2007/2008,41,2,14,12,-Inf
2007/2008,11,31,2007/2008,42,6,14,8,-Inf
2007/2008,11,32,2007/2008,43,8,15,7,-11.512925464970229
2007/2008,11,33,2007/2008,44,5,18,13,-Inf
2007/2008,11,34,2007/2008,45,1,16,15,-Inf
2007/2008,11,35,2007/2008,46,2,12,10,-Inf
2007/2008,11,36,2007/2008,47,3,20,17,-Inf
2007/2008,11,37,2007/2008,48,4,8,4,-Inf
2007/2008,11,38,2007/2008,49,3,3,0,-0.35460565781735554
2007/2008,11,39,2007/2008,50,1,13,12,-Inf
2007/2008,11,40,2007/2008,51,3,4,1,-Inf
2007/2008,11,41,2007/2008,52,5,1,4,-Inf
2007/2008,11,42,2008/2009,1,2,10,8,-11.512925464970229
2007/2008,11,43,2008/2009,2,3,8,5,-Inf
2007/2008,11,44,2008/2009,3,2,13,11,-Inf
2007/2008,11,45,2008/2009,4,3,10,7,-Inf
2007/2008,11,46,2008/2009,5,2,21,19,-Inf
2007/2008,11,47,2008/2009,6,2,18,16,-11.512925464970229
2007/2008,11,48,2008/2009,7,3,21,18,-Inf
2007/2008,11,49,2008/2009,8,4,34,30,-Inf
2007/2008,11,50,2008/2009,9,3,25,22,-Inf
2007/2008,11,51,2008/2009,10,4,34,30,-Inf
2007/2008,11,52,2008/2009,11,4,33,29,-Inf
2007/2008,12,1,2007/2008,13,42,14,28,-Inf
2007/2008,12,2,2007/2008,14,36,12,24,-Inf
2007/2008,12,3,2007/2008,15,72,16,56,-Inf
2007/2008,12,4,2007/2008,16,75,10,65,-Inf
2007/2008,12,5,2007/2008,17,76,16,60,-Inf
2007/2008,12,6,2007/2008,18,92,18,74,-Inf
2007/2008,12,7,2007/2008,19,71,15,56,-Inf
2007/2008,12,8,2007/2008,20,112,23,89,-Inf
2007/2008,12,9,2007/2008,21,106,17,89,-Inf
2007/2008,12,10,2007/2008,22,101,33,68,-Inf
2007/2008,12,11,2007/2008,23,170,15,155,-Inf
2007/2008,12,12,2007/2008,24,135,13,122,-Inf
2007/2008,12,13,2007/2008,25,106,11,95,-Inf
2007/2008,12,14,2007/2008,26,68,14,54,-Inf
2007/2008,12,15,2007/2008,27,48,17,31,-Inf
2007/2008,12,16,2007/2008,28,48,19,29,-Inf
2007/2008,12,17,2007/2008,29,26,20,6,-Inf
2007/2008,12,18,2007/2008,30,33,12,21,-Inf
2007/2008,12,19,2007/2008,31,29,21,8,-Inf
2007/2008,12,20,2007/2008,32,17,7,10,-Inf
2007/2008,12,21,2007/2008,33,12,19,7,-Inf
2007/2008,12,22,2007/2008,34,13,10,3,-Inf
2007/2008,12,23,2007/2008,35,17,13,4,-11.512925464970229
2007/2008,12,24,2007/2008,36,15,10,5,-Inf
2007/2008,12,25,2007/2008,37,14,8,6,-11.512925464970229
2007/2008,12,26,2007/2008,38,15,21,6,-Inf
2007/2008,12,27,2007/2008,39,10,11,1,-Inf
2007/2008,12,28,2007/2008,40,9,9,0,-0.3672882087697946
2007/2008,12,29,2007/2008,41,2,14,12,-Inf
2007/2008,12,30,2007/2008,42,6,14,8,-Inf
2007/2008,12,31,2007/2008,43,8,15,7,-Inf
2007/2008,12,32,2007/2008,44,5,18,13,-Inf
2007/2008,12,33,2007/2008,45,1,16,15,-Inf
2007/2008,12,34,2007/2008,46,2,12,10,-Inf
2007/2008,12,35,2007/2008,47,3,20,17,-Inf
2007/2008,12,36,2007/2008,48,4,8,4,-Inf
2007/2008,12,37,2007/2008,49,3,3,0,-0.3565606647545607
2007/2008,12,38,2007/2008,50,1,13,12,-Inf
2007/2008,12,39,2007/2008,51,3,4,1,-Inf
2007/2008,12,40,2007/2008,52,5,1,4,-Inf
2007/2008,12,41,2008/2009,1,2,10,8,-Inf
2007/2008,12,42,2008/2009,2,3,8,5,-Inf
2007/2008,12,43,2008/2009,3,2,13,11,-Inf
2007/2008,12,44,2008/2009,4,3,10,7,-Inf
2007/2008,12,45,2008/2009,5,2,21,19,-Inf
2007/2008,12,46,2008/2009,6,2,18,16,-Inf
2007/2008,12,47,2008/2009,7,3,21,18,-Inf
2007/2008,12,48,2008/2009,8,4,34,30,-Inf
2007/2008,12,49,2008/2009,9,3,25,22,-Inf
2007/2008,12,50,2008/2009,10,4,34,30,-Inf
2007/2008,12,51,2008/2009,11,4,33,29,-Inf
2007/2008,12,52,2008/2009,12,4,40,36,-Inf
2007/2008,13,1,2007/2008,14,36,12,24,-Inf
2007/2008,13,2,2007/2008,15,72,16,56,-Inf
2007/2008,13,3,2007/2008,16,75,10,65,-Inf
2007/2008,13,4,2007/2008,17,76,16,60,-Inf
2007/2008,13,5,2007/2008,18,92,18,74,-Inf
2007/2008,13,6,2007/2008,19,71,15,56,-Inf
2007/2008,13,7,2007/2008,20,112,23,89,-Inf
2007/2008,13,8,2007/2008,21,106,17,89,-Inf
2007/2008,13,9,2007/2008,22,101,33,68,-Inf
2007/2008,13,10,2007/2008,23,170,15,155,-Inf
2007/2008,13,11,2007/2008,24,135,13,122,-Inf
2007/2008,13,12,2007/2008,25,106,11,95,-Inf
2007/2008,13,13,2007/2008,26,68,14,54,-Inf
2007/2008,13,14,2007/2008,27,48,17,31,-Inf
2007/2008,13,15,2007/2008,28,48,19,29,-Inf
2007/2008,13,16,2007/2008,29,26,20,6,-11.512925464970229
2007/2008,13,17,2007/2008,30,33,12,21,-Inf
2007/2008,13,18,2007/2008,31,29,21,8,-Inf
2007/2008,13,19,2007/2008,32,17,7,10,-Inf
2007/2008,13,20,2007/2008,33,12,19,7,-Inf
2007/2008,13,21,2007/2008,34,13,10,3,-Inf
2007/2008,13,22,2007/2008,35,17,13,4,-Inf
2007/2008,13,23,2007/2008,36,15,10,5,-11.512925464970229
2007/2008,13,24,2007/2008,37,14,8,6,-Inf
2007/2008,13,25,2007/2008,38,15,21,6,-Inf
2007/2008,13,26,2007/2008,39,10,11,1,-10.819778284410283
2007/2008,13,27,2007/2008,40,9,9,0,-0.3679092415817298
2007/2008,13,28,2007/2008,41,2,14,12,-Inf
2007/2008,13,29,2007/2008,42,6,14,8,-Inf
2007/2008,13,30,2007/2008,43,8,15,7,-Inf
2007/2008,13,31,2007/2008,44,5,18,13,-Inf
2007/2008,13,32,2007/2008,45,1,16,15,-Inf
2007/2008,13,33,2007/2008,46,2,12,10,-Inf
2007/2008,13,34,2007/2008,47,3,20,17,-Inf
2007/2008,13,35,2007/2008,48,4,8,4,-Inf
2007/2008,13,36,2007/2008,49,3,3,0,-0.3585195012318909
2007/2008,13,37,2007/2008,50,1,13,12,-Inf
2007/2008,13,38,2007/2008,51,3,4,1,-Inf
2007/2008,13,39,2007/2008,52,5,1,4,-Inf
2007/2008,13,40,2008/2009,1,2,10,8,-Inf
2007/2008,13,41,2008/2009,2,3,8,5,-Inf
2007/2008,13,42,2008/2009,3,2,13,11,-Inf
2007/2008,13,43,2008/2009,4,3,10,7,-Inf
2007/2008,13,44,2008/2009,5,2,21,19,-Inf
2007/2008,13,45,2008/2009,6,2,18,16,-11.512925464970229
2007/2008,13,46,2008/2009,7,3,21,18,-Inf
2007/2008,13,47,2008/2009,8,4,34,30,-Inf
2007/2008,13,48,2008/2009,9,3,25,22,-Inf
2007/2008,13,49,2008/2009,10,4,34,30,-Inf
2007/2008,13,50,2008/2009,11,4,33,29,-Inf
2007/2008,13,51,2008/2009,12,4,40,36,-Inf
2007/2008,13,52,2008/2009,13,7,42,35,-Inf
2007/2008,14,1,2007/2008,15,72,16,56,-Inf
2007/2008,14,2,2007/2008,16,75,10,65,-Inf
2007/2008,14,3,2007/2008,17,76,16,60,-Inf
2007/2008,14,4,2007/2008,18,92,18,74,-Inf
2007/2008,14,5,2007/2008,19,71,15,56,-Inf
2007/2008,14,6,2007/2008,20,112,23,89,-Inf
2007/2008,14,7,2007/2008,21,106,17,89,-Inf
2007/2008,14,8,2007/2008,22,101,33,68,-Inf
2007/2008,14,9,2007/2008,23,170,15,155,-Inf
2007/2008,14,10,2007/2008,24,135,13,122,-Inf
2007/2008,14,11,2007/2008,25,106,11,95,-Inf
2007/2008,14,12,2007/2008,26,68,14,54,-Inf
2007/2008,14,13,2007/2008,27,48,17,31,-Inf
2007/2008,14,14,2007/2008,28,48,19,29,-Inf
2007/2008,14,15,2007/2008,29,26,20,6,-Inf
2007/2008,14,16,2007/2008,30,33,12,21,-Inf
2007/2008,14,17,2007/2008,31,29,21,8,-Inf
2007/2008,14,18,2007/2008,32,17,7,10,-Inf
2007/2008,14,19,2007/2008,33,12,19,7,-Inf
2007/2008,14,20,2007/2008,34,13,10,3,-11.512925464970229
2007/2008,14,21,2007/2008,35,17,13,4,-Inf
2007/2008,14,22,2007/2008,36,15,10,5,-11.512925464970229
2007/2008,14,23,2007/2008,37,14,8,6,-Inf
2007/2008,14,24,2007/2008,38,15,21,6,-Inf
2007/2008,14,25,2007/2008,39,10,11,1,-Inf
2007/2008,14,26,2007/2008,40,9,9,0,-0.3707738683182349
2007/2008,14,27,2007/2008,41,2,14,12,-Inf
2007/2008,14,28,2007/2008,42,6,14,8,-Inf
2007/2008,14,29,2007/2008,43,8,15,7,-Inf
2007/2008,14,30,2007/2008,44,5,18,13,-Inf
2007/2008,14,31,2007/2008,45,1,16,15,-Inf
2007/2008,14,32,2007/2008,46,2,12,10,-Inf
2007/2008,14,33,2007/2008,47,3,20,17,-Inf
2007/2008,14,34,2007/2008,48,4,8,4,-11.512925464970229
2007/2008,14,35,2007/2008,49,3,3,0,-0.35453437943962207
2007/2008,14,36,2007/2008,50,1,13,12,-Inf
2007/2008,14,37,2007/2008,51,3,4,1,-11.512925464970229
2007/2008,14,38,2007/2008,52,5,1,4,-11.512925464970229
2007/2008,14,39,2008/2009,1,2,10,8,-Inf
2007/2008,14,40,2008/2009,2,3,8,5,-Inf
2007/2008,14,41,2008/2009,3,2,13,11,-Inf
2007/2008,14,42,2008/2009,4,3,10,7,-Inf
2007/2008,14,43,2008/2009,5,2,21,19,-Inf
2007/2008,14,44,2008/2009,6,2,18,16,-Inf
2007/2008,14,45,2008/2009,7,3,21,18,-Inf
2007/2008,14,46,2008/2009,8,4,34,30,-Inf
2007/2008,14,47,2008/2009,9,3,25,22,-Inf
2007/2008,14,48,2008/2009,10,4,34,30,-Inf
2007/2008,14,49,2008/2009,11,4,33,29,-Inf
2007/2008,14,50,2008/2009,12,4,40,36,-Inf
2007/2008,14,51,2008/2009,13,7,42,35,-Inf
2007/2008,14,52,2008/2009,14,6,36,30,-Inf
2007/2008,15,1,2007/2008,16,75,10,65,-Inf
2007/2008,15,2,2007/2008,17,76,16,60,-Inf
2007/2008,15,3,2007/2008,18,92,18,74,-Inf
2007/2008,15,4,2007/2008,19,71,15,56,-Inf
2007/2008,15,5,2007/2008,20,112,23,89,-Inf
2007/2008,15,6,2007/2008,21,106,17,89,-Inf
2007/2008,15,7,2007/2008,22,101,33,68,-Inf
2007/2008,15,8,2007/2008,23,170,15,155,-Inf
2007/2008,15,9,2007/2008,24,135,13,122,-Inf
2007/2008,15,10,2007/2008,25,106,11,95,-Inf
2007/2008,15,11,2007/2008,26,68,14,54,-Inf
2007/2008,15,12,2007/2008,27,48,17,31,-Inf
2007/2008,15,13,2007/2008,28,48,19,29,-Inf
2007/2008,15,14,2007/2008,29,26,20,6,-Inf
2007/2008,15,15,2007/2008,30,33,12,21,-Inf
2007/2008,15,16,2007/2008,31,29,21,8,-11.512925464970229
2007/2008,15,17,2007/2008,32,17,7,10,-11.512925464970229
2007/2008,15,18,2007/2008,33,12,19,7,-Inf
2007/2008,15,19,2007/2008,34,13,10,3,-11.512925464970229
2007/2008,15,20,2007/2008,35,17,13,4,-11.512925464970229
2007/2008,15,21,2007/2008,36,15,10,5,-Inf
2007/2008,15,22,2007/2008,37,14,8,6,-11.512925464970229
2007/2008,15,23,2007/2008,38,15,21,6,-Inf
2007/2008,15,24,2007/2008,39,10,11,1,-11.512925464970229
2007/2008,15,25,2007/2008,40,9,9,0,-0.3703972368476709
2007/2008,15,26,2007/2008,41,2,14,12,-11.512925464970229
2007/2008,15,27,2007/2008,42,6,14,8,-Inf
2007/2008,15,28,2007/2008,43,8,15,7,-Inf
2007/2008,15,29,2007/2008,44,5,18,13,-Inf
2007/2008,15,30,2007/2008,45,1,16,15,-Inf
2007/2008,15,31,2007/2008,46,2,12,10,-Inf
2007/2008,15,32,2007/2008,47,3,20,17,-Inf
2007/2008,15,33,2007/2008,48,4,8,4,-Inf
2007/2008,15,34,2007/2008,49,3,3,0,-0.3587485208856407
2007/2008,15,35,2007/2008,50,1,13,12,-Inf
2007/2008,15,36,2007/2008,51,3,4,1,-Inf
2007/2008,15,37,2007/2008,52,5,1,4,-Inf
2007/2008,15,38,2008/2009,1,2,10,8,-Inf
2007/2008,15,39,2008/2009,2,3,8,5,-Inf
2007/2008,15,40,2008/2009,3,2,13,11,-Inf
2007/2008,15,41,2008/2009,4,3,10,7,-Inf
2007/2008,15,42,2008/2009,5,2,21,19,-Inf
2007/2008,15,43,2008/2009,6,2,18,16,-Inf
2007/2008,15,44,2008/2009,7,3,21,18,-Inf
2007/2008,15,45,2008/2009,8,4,34,30,-Inf
2007/2008,15,46,2008/2009,9,3,25,22,-Inf
2007/2008,15,47,2008/2009,10,4,34,30,-Inf
2007/2008,15,48,2008/2009,11,4,33,29,-Inf
2007/2008,15,49,2008/2009,12,4,40,36,-Inf
2007/2008,15,50,2008/2009,13,7,42,35,-Inf
2007/2008,15,51,2008/2009,14,6,36,30,-Inf
2007/2008,15,52,2008/2009,15,15,72,57,-Inf
2007/2008,16,1,2007/2008,17,76,16,60,-Inf
2007/2008,16,2,2007/2008,18,92,18,74,-Inf
2007/2008,16,3,2007/2008,19,71,15,56,-Inf
2007/2008,16,4,2007/2008,20,112,23,89,-Inf
2007/2008,16,5,2007/2008,21,106,17,89,-Inf
2007/2008,16,6,2007/2008,22,101,33,68,-Inf
2007/2008,16,7,2007/2008,23,170,15,155,-Inf
2007/2008,16,8,2007/2008,24,135,13,122,-Inf
2007/2008,16,9,2007/2008,25,106,11,95,-Inf
2007/2008,16,10,2007/2008,26,68,14,54,-11.512925464970229
2007/2008,16,11,2007/2008,27,48,17,31,-11.512925464970229
2007/2008,16,12,2007/2008,28,48,19,29,-Inf
2007/2008,16,13,2007/2008,29,26,20,6,-11.512925464970229
2007/2008,16,14,2007/2008,30,33,12,21,-Inf
2007/2008,16,15,2007/2008,31,29,21,8,-Inf
2007/2008,16,16,2007/2008,32,17,7,10,-Inf
2007/2008,16,17,2007/2008,33,12,19,7,-Inf
2007/2008,16,18,2007/2008,34,13,10,3,-Inf
2007/2008,16,19,2007/2008,35,17,13,4,-Inf
2007/2008,16,20,2007/2008,36,15,10,5,-Inf
2007/2008,16,21,2007/2008,37,14,8,6,-Inf
2007/2008,16,22,2007/2008,38,15,21,6,-Inf
2007/2008,16,23,2007/2008,39,10,11,1,-Inf
2007/2008,16,24,2007/2008,40,9,9,0,-0.3720061543644988
2007/2008,16,25,2007/2008,41,2,14,12,-Inf
2007/2008,16,26,2007/2008,42,6,14,8,-Inf
2007/2008,16,27,2007/2008,43,8,15,7,-Inf
2007/2008,16,28,2007/2008,44,5,18,13,-Inf
2007/2008,16,29,2007/2008,45,1,16,15,-Inf
2007/2008,16,30,2007/2008,46,2,12,10,-Inf
2007/2008,16,31,2007/2008,47,3,20,17,-Inf
2007/2008,16,32,2007/2008,48,4,8,4,-Inf
2007/2008,16,33,2007/2008,49,3,3,0,-0.35926400695745464
2007/2008,16,34,2007/2008,50,1,13,12,-Inf
2007/2008,16,35,2007/2008,51,3,4,1,-11.512925464970229
2007/2008,16,36,2007/2008,52,5,1,4,-Inf
2007/2008,16,37,2008/2009,1,2,10,8,-Inf
2007/2008,16,38,2008/2009,2,3,8,5,-Inf
2007/2008,16,39,2008/2009,3,2,13,11,-Inf
2007/2008,16,40,2008/2009,4,3,10,7,-Inf
2007/2008,16,41,2008/2009,5,2,21,19,-Inf
2007/2008,16,42,2008/2009,6,2,18,16,-Inf
2007/2008,16,43,2008/2009,7,3,21,18,-Inf
2007/2008,16,44,2008/2009,8,4,34,30,-Inf
2007/2008,16,45,2008/2009,9,3,25,22,-Inf
2007/2008,16,46,2008/2009,10,4,34,30,-Inf
2007/2008,16,47,2008/2009,11,4,33,29,-Inf
2007/2008,16,48,2008/2009,12,4,40,36,-Inf
2007/2008,16,49,2008/2009,13,7,42,35,-Inf
2007/2008,16,50,2008/2009,14,6,36,30,-Inf
2007/2008,16,51,2008/2009,15,15,72,57,-Inf
2007/2008,16,52,2008/2009,16,11,75,64,-Inf
2007/2008,17,1,2007/2008,18,92,18,74,-Inf
2007/2008,17,2,2007/2008,19,71,15,56,-Inf
2007/2008,17,3,2007/2008,20,112,23,89,-Inf
2007/2008,17,4,2007/2008,21,106,17,89,-Inf
2007/2008,17,5,2007/2008,22,101,33,68,-Inf
2007/2008,17,6,2007/2008,23,170,15,155,-Inf
2007/2008,17,7,2007/2008,24,135,13,122,-Inf
2007/2008,17,8,2007/2008,25,106,11,95,-Inf
2007/2008,17,9,2007/2008,26,68,14,54,-Inf
2007/2008,17,10,2007/2008,27,48,17,31,-Inf
2007/2008,17,11,2007/2008,28,48,19,29,-Inf
2007/2008,17,12,2007/2008,29,26,20,6,-11.512925464970229
2007/2008,17,13,2007/2008,30,33,12,21,-11.512925464970229
2007/2008,17,14,2007/2008,31,29,21,8,-Inf
2007/2008,17,15,2007/2008,32,17,7,10,-11.512925464970229
2007/2008,17,16,2007/2008,33,12,19,7,-Inf
2007/2008,17,17,2007/2008,34,13,10,3,-10.819778284410283
2007/2008,17,18,2007/2008,35,17,13,4,-Inf
2007/2008,17,19,2007/2008,36,15,10,5,-Inf
2007/2008,17,20,2007/2008,37,14,8,6,-Inf
2007/2008,17,21,2007/2008,38,15,21,6,-Inf
2007/2008,17,22,2007/2008,39,10,11,1,-Inf
2007/2008,17,23,2007/2008,40,9,9,0,-0.37438804153769745
2007/2008,17,24,2007/2008,41,2,14,12,-Inf
2007/2008,17,25,2007/2008,42,6,14,8,-Inf
2007/2008,17,26,2007/2008,43,8,15,7,-11.512925464970229
2007/2008,17,27,2007/2008,44,5,18,13,-Inf
2007/2008,17,28,2007/2008,45,1,16,15,-Inf
2007/2008,17,29,2007/2008,46,2,12,10,-Inf
2007/2008,17,30,2007/2008,47,3,20,17,-Inf
2007/2008,17,31,2007/2008,48,4,8,4,-11.512925464970229
2007/2008,17,32,2007/2008,49,3,3,0,-0.36216139559903127
2007/2008,17,33,2007/2008,50,1,13,12,-Inf
2007/2008,17,34,2007/2008,51,3,4,1,-11.512925464970229
2007/2008,17,35,2007/2008,52,5,1,4,-Inf
2007/2008,17,36,2008/2009,1,2,10,8,-Inf
2007/2008,17,37,2008/2009,2,3,8,5,-Inf
2007/2008,17,38,2008/2009,3,2,13,11,-Inf
2007/2008,17,39,2008/2009,4,3,10,7,-Inf
2007/2008,17,40,2008/2009,5,2,21,19,-Inf
2007/2008,17,41,2008/2009,6,2,18,16,-Inf
2007/2008,17,42,2008/2009,7,3,21,18,-Inf
2007/2008,17,43,2008/2009,8,4,34,30,-Inf
2007/2008,17,44,2008/2009,9,3,25,22,-Inf
2007/2008,17,45,2008/2009,10,4,34,30,-Inf
2007/2008,17,46,2008/2009,11,4,33,29,-Inf
2007/2008,17,47,2008/2009,12,4,40,36,-Inf
2007/2008,17,48,2008/2009,13,7,42,35,-Inf
2007/2008,17,49,2008/2009,14,6,36,30,-Inf
2007/2008,17,50,2008/2009,15,15,72,57,-Inf
2007/2008,17,51,2008/2009,16,11,75,64,-Inf
2007/2008,17,52,2008/2009,17,9,76,67,-Inf
2007/2008,18,1,2007/2008,19,71,15,56,-Inf
2007/2008,18,2,2007/2008,20,112,23,89,-Inf
2007/2008,18,3,2007/2008,21,106,17,89,-Inf
2007/2008,18,4,2007/2008,22,101,33,68,-Inf
2007/2008,18,5,2007/2008,23,170,15,155,-Inf
2007/2008,18,6,2007/2008,24,135,13,122,-Inf
2007/2008,18,7,2007/2008,25,106,11,95,-Inf
2007/2008,18,8,2007/2008,26,68,14,54,-Inf
2007/2008,18,9,2007/2008,27,48,17,31,-Inf
2007/2008,18,10,2007/2008,28,48,19,29,-Inf
2007/2008,18,11,2007/2008,29,26,20,6,-Inf
2007/2008,18,12,2007/2008,30,33,12,21,-Inf
2007/2008,18,13,2007/2008,31,29,21,8,-11.512925464970229
2007/2008,18,14,2007/2008,32,17,7,10,-Inf
2007/2008,18,15,2007/2008,33,12,19,7,-Inf
2007/2008,18,16,2007/2008,34,13,10,3,-10.819778284410283
2007/2008,18,17,2007/2008,35,17,13,4,-10.41431317630212
2007/2008,18,18,2007/2008,36,15,10,5,-Inf
2007/2008,18,19,2007/2008,37,14,8,6,-Inf
2007/2008,18,20,2007/2008,38,15,21,6,-Inf
2007/2008,18,21,2007/2008,39,10,11,1,-10.819778284410283
2007/2008,18,22,2007/2008,40,9,9,0,-0.37792776511507675
2007/2008,18,23,2007/2008,41,2,14,12,-Inf
2007/2008,18,24,2007/2008,42,6,14,8,-Inf
2007/2008,18,25,2007/2008,43,8,15,7,-Inf
2007/2008,18,26,2007/2008,44,5,18,13,-Inf
2007/2008,18,27,2007/2008,45,1,16,15,-Inf
2007/2008,18,28,2007/2008,46,2,12,10,-Inf
2007/2008,18,29,2007/2008,47,3,20,17,-Inf
2007/2008,18,30,2007/2008,48,4,8,4,-Inf
2007/2008,18,31,2007/2008,49,3,3,0,-0.3630380024682687
2007/2008,18,32,2007/2008,50,1,13,12,-Inf
2007/2008,18,33,2007/2008,51,3,4,1,-11.512925464970229
2007/2008,18,34,2007/2008,52,5,1,4,-Inf
2007/2008,18,35,2008/2009,1,2,10,8,-Inf
2007/2008,18,36,2008/2009,2,3,8,5,-Inf
2007/2008,18,37,2008/2009,3,2,13,11,-11.512925464970229
2007/2008,18,38,2008/2009,4,3,10,7,-Inf
2007/2008,18,39,2008/2009,5,2,21,19,-Inf
2007/2008,18,40,2008/2009,6,2,18,16,-Inf
2007/2008,18,41,2008/2009,7,3,21,18,-Inf
2007/2008,18,42,2008/2009,8,4,34,30,-Inf
2007/2008,18,43,2008/2009,9,3,25,22,-Inf
2007/2008,18,44,2008/2009,10,4,34,30,-Inf
2007/2008,18,45,2008/2009,11,4,33,29,-Inf
2007/2008,18,46,2008/2009,12,4,40,36,-Inf
2007/2008,18,47,2008/2009,13,7,42,35,-Inf
2007/2008,18,48,2008/2009,14,6,36,30,-Inf
2007/2008,18,49,2008/2009,15,15,72,57,-Inf
2007/2008,18,50,2008/2009,16,11,75,64,-Inf
2007/2008,18,51,2008/2009,17,9,76,67,-Inf
2007/2008,18,52,2008/2009,18,9,92,83,-11.512925464970229
2007/2008,19,1,2007/2008,20,112,23,89,-Inf
2007/2008,19,2,2007/2008,21,106,17,89,-Inf
2007/2008,19,3,2007/2008,22,101,33,68,-Inf
2007/2008,19,4,2007/2008,23,170,15,155,-Inf
2007/2008,19,5,2007/2008,24,135,13,122,-Inf
2007/2008,19,6,2007/2008,25,106,11,95,-Inf
2007/2008,19,7,2007/2008,26,68,14,54,-Inf
2007/2008,19,8,2007/2008,27,48,17,31,-Inf
2007/2008,19,9,2007/2008,28,48,19,29,-Inf
2007/2008,19,10,2007/2008,29,26,20,6,-Inf
2007/2008,19,11,2007/2008,30,33,12,21,-Inf
2007/2008,19,12,2007/2008,31,29,21,8,-Inf
2007/2008,19,13,2007/2008,32,17,7,10,-Inf
2007/2008,19,14,2007/2008,33,12,19,7,-Inf
2007/2008,19,15,2007/2008,34,13,10,3,-11.512925464970229
2007/2008,19,16,2007/2008,35,17,13,4,-Inf
2007/2008,19,17,2007/2008,36,15,10,5,-Inf
2007/2008,19,18,2007/2008,37,14,8,6,-Inf
2007/2008,19,19,2007/2008,38,15,21,6,-Inf
2007/2008,19,20,2007/2008,39,10,11,1,-Inf
2007/2008,19,21,2007/2008,40,9,9,0,-0.38085054734424517
2007/2008,19,22,2007/2008,41,2,14,12,-Inf
2007/2008,19,23,2007/2008,42,6,14,8,-Inf
2007/2008,19,24,2007/2008,43,8,15,7,-Inf
2007/2008,19,25,2007/2008,44,5,18,13,-Inf
2007/2008,19,26,2007/2008,45,1,16,15,-Inf
2007/2008,19,27,2007/2008,46,2,12,10,-Inf
2007/2008,19,28,2007/2008,47,3,20,17,-Inf
2007/2008,19,29,2007/2008,48,4,8,4,-Inf
2007/2008,19,30,2007/2008,49,3,3,0,-0.36454871804330935
2007/2008,19,31,2007/2008,50,1,13,12,-Inf
2007/2008,19,32,2007/2008,51,3,4,1,-Inf
2007/2008,19,33,2007/2008,52,5,1,4,-Inf
2007/2008,19,34,2008/2009,1,2,10,8,-Inf
2007/2008,19,35,2008/2009,2,3,8,5,-Inf
2007/2008,19,36,2008/2009,3,2,13,11,-11.512925464970229
2007/2008,19,37,2008/2009,4,3,10,7,-Inf
2007/2008,19,38,2008/2009,5,2,21,19,-Inf
2007/2008,19,39,2008/2009,6,2,18,16,-Inf
2007/2008,19,40,2008/2009,7,3,21,18,-Inf
2007/2008,19,41,2008/2009,8,4,34,30,-11.512925464970229
2007/2008,19,42,2008/2009,9,3,25,22,-Inf
2007/2008,19,43,2008/2009,10,4,34,30,-Inf
2007/2008,19,44,2008/2009,11,4,33,29,-Inf
2007/2008,19,45,2008/2009,12,4,40,36,-Inf
2007/2008,19,46,2008/2009,13,7,42,35,-Inf
2007/2008,19,47,2008/2009,14,6,36,30,-Inf
2007/2008,19,48,2008/2009,15,15,72,57,-Inf
2007/2008,19,49,2008/2009,16,11,75,64,-Inf
2007/2008,19,50,2008/2009,17,9,76,67,-Inf
2007/2008,19,51,2008/2009,18,9,92,83,-Inf
2007/2008,19,52,2008/2009,19,12,71,59,-Inf
2007/2008,1,1,2007/2008,2,8,7,1,-11.512925464970229
2007/2008,1,2,2007/2008,3,13,3,10,-Inf
2007/2008,1,3,2007/2008,4,10,5,5,-Inf
2007/2008,1,4,2007/2008,5,21,11,10,-Inf
2007/2008,1,5,2007/2008,6,18,5,13,-Inf
2007/2008,1,6,2007/2008,7,21,5,16,-Inf
2007/2008,1,7,2007/2008,8,34,6,28,-Inf
2007/2008,1,8,2007/2008,9,25,6,19,-Inf
2007/2008,1,9,2007/2008,10,34,4,30,-Inf
2007/2008,1,10,2007/2008,11,33,4,29,-Inf
2007/2008,1,11,2007/2008,12,40,8,32,-11.512925464970229
2007/2008,1,12,2007/2008,13,42,14,28,-Inf
2007/2008,1,13,2007/2008,14,36,12,24,-Inf
2007/2008,1,14,2007/2008,15,72,16,56,-Inf
2007/2008,1,15,2007/2008,16,75,10,65,-Inf
2007/2008,1,16,2007/2008,17,76,16,60,-Inf
2007/2008,1,17,2007/2008,18,92,18,74,-Inf
2007/2008,1,18,2007/2008,19,71,15,56,-Inf
2007/2008,1,19,2007/2008,20,112,23,89,-Inf
2007/2008,1,20,2007/2008,21,106,17,89,-Inf
2007/2008,1,21,2007/2008,22,101,33,68,-11.512925464970229
2007/2008,1,22,2007/2008,23,170,15,155,-Inf
2007/2008,1,23,2007/2008,24,135,13,122,-Inf
2007/2008,1,24,2007/2008,25,106,11,95,-Inf
2007/2008,1,25,2007/2008,26,68,14,54,-Inf
2007/2008,1,26,2007/2008,27,48,17,31,-Inf
2007/2008,1,27,2007/2008,28,48,19,29,-Inf
2007/2008,1,28,2007/2008,29,26,20,6,-Inf
2007/2008,1,29,2007/2008,30,33,12,21,-Inf
2007/2008,1,30,2007/2008,31,29,21,8,-Inf
2007/2008,1,31,2007/2008,32,17,7,10,-Inf
2007/2008,1,32,2007/2008,33,12,19,7,-Inf
2007/2008,1,33,2007/2008,34,13,10,3,-Inf
2007/2008,1,34,2007/2008,35,17,13,4,-Inf
2007/2008,1,35,2007/2008,36,15,10,5,-Inf
2007/2008,1,36,2007/2008,37,14,8,6,-Inf
2007/2008,1,37,2007/2008,38,15,21,6,-Inf
2007/2008,1,38,2007/2008,39,10,11,1,-10.41431317630212
2007/2008,1,39,2007/2008,40,9,9,0,-0.33418685010753535
2007/2008,1,40,2007/2008,41,2,14,12,-11.512925464970229
2007/2008,1,41,2007/2008,42,6,14,8,-Inf
2007/2008,1,42,2007/2008,43,8,15,7,-Inf
2007/2008,1,43,2007/2008,44,5,18,13,-Inf
2007/2008,1,44,2007/2008,45,1,16,15,-Inf
2007/2008,1,45,2007/2008,46,2,12,10,-11.512925464970229
2007/2008,1,46,2007/2008,47,3,20,17,-Inf
2007/2008,1,47,2007/2008,48,4,8,4,-Inf
2007/2008,1,48,2007/2008,49,3,3,0,-0.3418567068980529
2007/2008,1,49,2007/2008,50,1,13,12,-Inf
2007/2008,1,50,2007/2008,51,3,4,1,-Inf
2007/2008,1,51,2007/2008,52,5,1,4,-Inf
2007/2008,1,52,2008/2009,1,2,10,8,-Inf
2007/2008,20,1,2007/2008,21,106,17,89,-Inf
2007/2008,20,2,2007/2008,22,101,33,68,-Inf
2007/2008,20,3,2007/2008,23,170,15,155,-Inf
2007/2008,20,4,2007/2008,24,135,13,122,-Inf
2007/2008,20,5,2007/2008,25,106,11,95,-Inf
2007/2008,20,6,2007/2008,26,68,14,54,-Inf
2007/2008,20,7,2007/2008,27,48,17,31,-11.512925464970229
2007/2008,20,8,2007/2008,28,48,19,29,-Inf
2007/2008,20,9,2007/2008,29,26,20,6,-Inf
2007/2008,20,10,2007/2008,30,33,12,21,-Inf
2007/2008,20,11,2007/2008,31,29,21,8,-11.512925464970229
2007/2008,20,12,2007/2008,32,17,7,10,-Inf
2007/2008,20,13,2007/2008,33,12,19,7,-Inf
2007/2008,20,14,2007/2008,34,13,10,3,-10.819778284410283
2007/2008,20,15,2007/2008,35,17,13,4,-Inf
2007/2008,20,16,2007/2008,36,15,10,5,-Inf
2007/2008,20,17,2007/2008,37,14,8,6,-Inf
2007/2008,20,18,2007/2008,38,15,21,6,-Inf
2007/2008,20,19,2007/2008,39,10,11,1,-11.512925464970229
2007/2008,20,20,2007/2008,40,9,9,0,-0.3833416466205417
2007/2008,20,21,2007/2008,41,2,14,12,-Inf
2007/2008,20,22,2007/2008,42,6,14,8,-Inf
2007/2008,20,23,2007/2008,43,8,15,7,-Inf
2007/2008,20,24,2007/2008,44,5,18,13,-Inf
2007/2008,20,25,2007/2008,45,1,16,15,-Inf
2007/2008,20,26,2007/2008,46,2,12,10,-Inf
2007/2008,20,27,2007/2008,47,3,20,17,-Inf
2007/2008,20,28,2007/2008,48,4,8,4,-Inf
2007/2008,20,29,2007/2008,49,3,3,0,-0.36459191489858433
2007/2008,20,30,2007/2008,50,1,13,12,-Inf
2007/2008,20,31,2007/2008,51,3,4,1,-11.512925464970229
2007/2008,20,32,2007/2008,52,5,1,4,-Inf
2007/2008,20,33,2008/2009,1,2,10,8,-Inf
2007/2008,20,34,2008/2009,2,3,8,5,-11.512925464970229
2007/2008,20,35,2008/2009,3,2,13,11,-Inf
2007/2008,20,36,2008/2009,4,3,10,7,-Inf
2007/2008,20,37,2008/2009,5,2,21,19,-Inf
2007/2008,20,38,2008/2009,6,2,18,16,-Inf
2007/2008,20,39,2008/2009,7,3,21,18,-Inf
2007/2008,20,40,2008/2009,8,4,34,30,-Inf
2007/2008,20,41,2008/2009,9,3,25,22,-Inf
2007/2008,20,42,2008/2009,10,4,34,30,-Inf
2007/2008,20,43,2008/2009,11,4,33,29,-Inf
2007/2008,20,44,2008/2009,12,4,40,36,-Inf
2007/2008,20,45,2008/2009,13,7,42,35,-Inf
2007/2008,20,46,2008/2009,14,6,36,30,-Inf
2007/2008,20,47,2008/2009,15,15,72,57,-Inf
2007/2008,20,48,2008/2009,16,11,75,64,-Inf
2007/2008,20,49,2008/2009,17,9,76,67,-Inf
2007/2008,20,50,2008/2009,18,9,92,83,-Inf
2007/2008,20,51,2008/2009,19,12,71,59,-Inf
2007/2008,20,52,2008/2009,20,13,112,99,-Inf
2007/2008,21,1,2007/2008,22,101,33,68,-Inf
2007/2008,21,2,2007/2008,23,170,15,155,-Inf
2007/2008,21,3,2007/2008,24,135,13,122,-Inf
2007/2008,21,4,2007/2008,25,106,11,95,-Inf
2007/2008,21,5,2007/2008,26,68,14,54,-Inf
2007/2008,21,6,2007/2008,27,48,17,31,-Inf
2007/2008,21,7,2007/2008,28,48,19,29,-Inf
2007/2008,21,8,2007/2008,29,26,20,6,-Inf
2007/2008,21,9,2007/2008,30,33,12,21,-Inf
2007/2008,21,10,2007/2008,31,29,21,8,-11.512925464970229
2007/2008,21,11,2007/2008,32,17,7,10,-Inf
2007/2008,21,12,2007/2008,33,12,19,7,-Inf
2007/2008,21,13,2007/2008,34,13,10,3,-Inf
2007/2008,21,14,2007/2008,35,17,13,4,-10.819778284410283
2007/2008,21,15,2007/2008,36,15,10,5,-Inf
2007/2008,21,16,2007/2008,37,14,8,6,-Inf
2007/2008,21,17,2007/2008,38,15,21,6,-Inf
2007/2008,21,18,2007/2008,39,10,11,1,-Inf
2007/2008,21,19,2007/2008,40,9,9,0,-0.38554484067303463
2007/2008,21,20,2007/2008,41,2,14,12,-Inf
2007/2008,21,21,2007/2008,42,6,14,8,-Inf
2007/2008,21,22,2007/2008,43,8,15,7,-Inf
2007/2008,21,23,2007/2008,44,5,18,13,-Inf
2007/2008,21,24,2007/2008,45,1,16,15,-Inf
2007/2008,21,25,2007/2008,46,2,12,10,-Inf
2007/2008,21,26,2007/2008,47,3,20,17,-Inf
2007/2008,21,27,2007/2008,48,4,8,4,-Inf
2007/2008,21,28,2007/2008,49,3,3,0,-0.3672882087697946
2007/2008,21,29,2007/2008,50,1,13,12,-Inf
2007/2008,21,30,2007/2008,51,3,4,1,-11.512925464970229
2007/2008,21,31,2007/2008,52,5,1,4,-Inf
2007/2008,21,32,2008/2009,1,2,10,8,-11.512925464970229
2007/2008,21,33,2008/2009,2,3,8,5,-Inf
2007/2008,21,34,2008/2009,3,2,13,11,-Inf
2007/2008,21,35,2008/2009,4,3,10,7,-Inf
2007/2008,21,36,2008/2009,5,2,21,19,-Inf
2007/2008,21,37,2008/2009,6,2,18,16,-Inf
2007/2008,21,38,2008/2009,7,3,21,18,-Inf
2007/2008,21,39,2008/2009,8,4,34,30,-Inf
2007/2008,21,40,2008/2009,9,3,25,22,-Inf
2007/2008,21,41,2008/2009,10,4,34,30,-Inf
2007/2008,21,42,2008/2009,11,4,33,29,-Inf
2007/2008,21,43,2008/2009,12,4,40,36,-Inf
2007/2008,21,44,2008/2009,13,7,42,35,-Inf
2007/2008,21,45,2008/2009,14,6,36,30,-Inf
2007/2008,21,46,2008/2009,15,15,72,57,-Inf
2007/2008,21,47,2008/2009,16,11,75,64,-Inf
2007/2008,21,48,2008/2009,17,9,76,67,-Inf
2007/2008,21,49,2008/2009,18,9,92,83,-Inf
2007/2008,21,50,2008/2009,19,12,71,59,-Inf
2007/2008,21,51,2008/2009,20,13,112,99,-Inf
2007/2008,21,52,2008/2009,21,13,106,93,-Inf
2007/2008,22,1,2007/2008,23,170,15,155,-Inf
2007/2008,22,2,2007/2008,24,135,13,122,-Inf
2007/2008,22,3,2007/2008,25,106,11,95,-Inf
2007/2008,22,4,2007/2008,26,68,14,54,-Inf
2007/2008,22,5,2007/2008,27,48,17,31,-Inf
2007/2008,22,6,2007/2008,28,48,19,29,-Inf
2007/2008,22,7,2007/2008,29,26,20,6,-Inf
2007/2008,22,8,2007/2008,30,33,12,21,-Inf
2007/2008,22,9,2007/2008,31,29,21,8,-11.512925464970229
2007/2008,22,10,2007/2008,32,17,7,10,-Inf
2007/2008,22,11,2007/2008,33,12,19,7,-Inf
2007/2008,22,12,2007/2008,34,13,10,3,-11.512925464970229
2007/2008,22,13,2007/2008,35,17,13,4,-Inf
2007/2008,22,14,2007/2008,36,15,10,5,-11.512925464970229
2007/2008,22,15,2007/2008,37,14,8,6,-Inf
2007/2008,22,16,2007/2008,38,15,21,6,-Inf
2007/2008,22,17,2007/2008,39,10,11,1,-10.819778284410283
2007/2008,22,18,2007/2008,40,9,9,0,-0.38688381457181364
2007/2008,22,19,2007/2008,41,2,14,12,-Inf
2007/2008,22,20,2007/2008,42,6,14,8,-Inf
2007/2008,22,21,2007/2008,43,8,15,7,-Inf
2007/2008,22,22,2007/2008,44,5,18,13,-Inf
2007/2008,22,23,2007/2008,45,1,16,15,-Inf
2007/2008,22,24,2007/2008,46,2,12,10,-Inf
2007/2008,22,25,2007/2008,47,3,20,17,-Inf
2007/2008,22,26,2007/2008,48,4,8,4,-Inf
2007/2008,22,27,2007/2008,49,3,3,0,-0.3679092415817298
2007/2008,22,28,2007/2008,50,1,13,12,-11.512925464970229
2007/2008,22,29,2007/2008,51,3,4,1,-Inf
2007/2008,22,30,2007/2008,52,5,1,4,-Inf
2007/2008,22,31,2008/2009,1,2,10,8,-Inf
2007/2008,22,32,2008/2009,2,3,8,5,-11.512925464970229
2007/2008,22,33,2008/2009,3,2,13,11,-Inf
2007/2008,22,34,2008/2009,4,3,10,7,-Inf
2007/2008,22,35,2008/2009,5,2,21,19,-Inf
2007/2008,22,36,2008/2009,6,2,18,16,-Inf
2007/2008,22,37,2008/2009,7,3,21,18,-Inf
2007/2008,22,38,2008/2009,8,4,34,30,-Inf
2007/2008,22,39,2008/2009,9,3,25,22,-Inf
2007/2008,22,40,2008/2009,10,4,34,30,-Inf
2007/2008,22,41,2008/2009,11,4,33,29,-11.512925464970229
2007/2008,22,42,2008/2009,12,4,40,36,-Inf
2007/2008,22,43,2008/2009,13,7,42,35,-Inf
2007/2008,22,44,2008/2009,14,6,36,30,-Inf
2007/2008,22,45,2008/2009,15,15,72,57,-Inf
2007/2008,22,46,2008/2009,16,11,75,64,-Inf
2007/2008,22,47,2008/2009,17,9,76,67,-Inf
2007/2008,22,48,2008/2009,18,9,92,83,-Inf
2007/2008,22,49,2008/2009,19,12,71,59,-Inf
2007/2008,22,50,2008/2009,20,13,112,99,-Inf
2007/2008,22,51,2008/2009,21,13,106,93,-Inf
2007/2008,22,52,2008/2009,22,13,101,88,-Inf
2007/2008,23,1,2007/2008,24,135,13,122,-Inf
2007/2008,23,2,2007/2008,25,106,11,95,-Inf
2007/2008,23,3,2007/2008,26,68,14,54,-Inf
2007/2008,23,4,2007/2008,27,48,17,31,-Inf
2007/2008,23,5,2007/2008,28,48,19,29,-Inf
2007/2008,23,6,2007/2008,29,26,20,6,-11.512925464970229
2007/2008,23,7,2007/2008,30,33,12,21,-Inf
2007/2008,23,8,2007/2008,31,29,21,8,-Inf
2007/2008,23,9,2007/2008,32,17,7,10,-Inf
2007/2008,23,10,2007/2008,33,12,19,7,-Inf
2007/2008,23,11,2007/2008,34,13,10,3,-11.512925464970229
2007/2008,23,12,2007/2008,35,17,13,4,-Inf
2007/2008,23,13,2007/2008,36,15,10,5,-Inf
2007/2008,23,14,2007/2008,37,14,8,6,-11.512925464970229
2007/2008,23,15,2007/2008,38,15,21,6,-Inf
2007/2008,23,16,2007/2008,39,10,11,1,-Inf
2007/2008,23,17,2007/2008,40,9,9,0,-0.3904681271022561
2007/2008,23,18,2007/2008,41,2,14,12,-Inf
2007/2008,23,19,2007/2008,42,6,14,8,-Inf
2007/2008,23,20,2007/2008,43,8,15,7,-Inf
2007/2008,23,21,2007/2008,44,5,18,13,-Inf
2007/2008,23,22,2007/2008,45,1,16,15,-Inf
2007/2008,23,23,2007/2008,46,2,12,10,-Inf
2007/2008,23,24,2007/2008,47,3,20,17,-Inf
2007/2008,23,25,2007/2008,48,4,8,4,-Inf
2007/2008,23,26,2007/2008,49,3,3,0,-0.3707738683182349
2007/2008,23,27,2007/2008,50,1,13,12,-Inf
2007/2008,23,28,2007/2008,51,3,4,1,-11.512925464970229
2007/2008,23,29,2007/2008,52,5,1,4,-Inf
2007/2008,23,30,2008/2009,1,2,10,8,-Inf
2007/2008,23,31,2008/2009,2,3,8,5,-Inf
2007/2008,23,32,2008/2009,3,2,13,11,-Inf
2007/2008,23,33,2008/2009,4,3,10,7,-Inf
2007/2008,23,34,2008/2009,5,2,21,19,-Inf
2007/2008,23,35,2008/2009,6,2,18,16,-Inf
2007/2008,23,36,2008/2009,7,3,21,18,-Inf
2007/2008,23,37,2008/2009,8,4,34,30,-Inf
2007/2008,23,38,2008/2009,9,3,25,22,-Inf
2007/2008,23,39,2008/2009,10,4,34,30,-Inf
2007/2008,23,40,2008/2009,11,4,33,29,-Inf
2007/2008,23,41,2008/2009,12,4,40,36,-Inf
2007/2008,23,42,2008/2009,13,7,42,35,-Inf
2007/2008,23,43,2008/2009,14,6,36,30,-Inf
2007/2008,23,44,2008/2009,15,15,72,57,-Inf
2007/2008,23,45,2008/2009,16,11,75,64,-11.512925464970229
2007/2008,23,46,2008/2009,17,9,76,67,-Inf
2007/2008,23,47,2008/2009,18,9,92,83,-Inf
2007/2008,23,48,2008/2009,19,12,71,59,-Inf
2007/2008,23,49,2008/2009,20,13,112,99,-Inf
2007/2008,23,50,2008/2009,21,13,106,93,-Inf
2007/2008,23,51,2008/2009,22,13,101,88,-Inf
2007/2008,23,52,2008/2009,23,20,170,150,-Inf
2007/2008,24,1,2007/2008,25,106,11,95,-Inf
2007/2008,24,2,2007/2008,26,68,14,54,-Inf
2007/2008,24,3,2007/2008,27,48,17,31,-Inf
2007/2008,24,4,2007/2008,28,48,19,29,-Inf
2007/2008,24,5,2007/2008,29,26,20,6,-Inf
2007/2008,24,6,2007/2008,30,33,12,21,-Inf
2007/2008,24,7,2007/2008,31,29,21,8,-Inf
2007/2008,24,8,2007/2008,32,17,7,10,-Inf
2007/2008,24,9,2007/2008,33,12,19,7,-Inf
2007/2008,24,10,2007/2008,34,13,10,3,-Inf
2007/2008,24,11,2007/2008,35,17,13,4,-Inf
2007/2008,24,12,2007/2008,36,15,10,5,-10.819778284410283
2007/2008,24,13,2007/2008,37,14,8,6,-Inf
2007/2008,24,14,2007/2008,38,15,21,6,-Inf
2007/2008,24,15,2007/2008,39,10,11,1,-11.512925464970229
2007/2008,24,16,2007/2008,40,9,9,0,-0.3946735470299654
2007/2008,24,17,2007/2008,41,2,14,12,-Inf
2007/2008,24,18,2007/2008,42,6,14,8,-Inf
2007/2008,24,19,2007/2008,43,8,15,7,-Inf
2007/2008,24,20,2007/2008,44,5,18,13,-Inf
2007/2008,24,21,2007/2008,45,1,16,15,-Inf
2007/2008,24,22,2007/2008,46,2,12,10,-Inf
2007/2008,24,23,2007/2008,47,3,20,17,-Inf
2007/2008,24,24,2007/2008,48,4,8,4,-Inf
2007/2008,24,25,2007/2008,49,3,3,0,-0.37041172005077705
2007/2008,24,26,2007/2008,50,1,13,12,-Inf
2007/2008,24,27,2007/2008,51,3,4,1,-Inf
2007/2008,24,28,2007/2008,52,5,1,4,-Inf
2007/2008,24,29,2008/2009,1,2,10,8,-Inf
2007/2008,24,30,2008/2009,2,3,8,5,-Inf
2007/2008,24,31,2008/2009,3,2,13,11,-Inf
2007/2008,24,32,2008/2009,4,3,10,7,-11.512925464970229
2007/2008,24,33,2008/2009,5,2,21,19,-Inf
2007/2008,24,34,2008/2009,6,2,18,16,-Inf
2007/2008,24,35,2008/2009,7,3,21,18,-Inf
2007/2008,24,36,2008/2009,8,4,34,30,-Inf
2007/2008,24,37,2008/2009,9,3,25,22,-Inf
2007/2008,24,38,2008/2009,10,4,34,30,-Inf
2007/2008,24,39,2008/2009,11,4,33,29,-Inf
2007/2008,24,40,2008/2009,12,4,40,36,-Inf
2007/2008,24,41,2008/2009,13,7,42,35,-Inf
2007/2008,24,42,2008/2009,14,6,36,30,-Inf
2007/2008,24,43,2008/2009,15,15,72,57,-Inf
2007/2008,24,44,2008/2009,16,11,75,64,-Inf
2007/2008,24,45,2008/2009,17,9,76,67,-Inf
2007/2008,24,46,2008/2009,18,9,92,83,-Inf
2007/2008,24,47,2008/2009,19,12,71,59,-Inf
2007/2008,24,48,2008/2009,20,13,112,99,-Inf
2007/2008,24,49,2008/2009,21,13,106,93,-Inf
2007/2008,24,50,2008/2009,22,13,101,88,-Inf
2007/2008,24,51,2008/2009,23,20,170,150,-Inf
2007/2008,24,52,2008/2009,24,28,135,107,-Inf
2007/2008,25,1,2007/2008,26,68,14,54,-Inf
2007/2008,25,2,2007/2008,27,48,17,31,-Inf
2007/2008,25,3,2007/2008,28,48,19,29,-Inf
2007/2008,25,4,2007/2008,29,26,20,6,-Inf
2007/2008,25,5,2007/2008,30,33,12,21,-Inf
2007/2008,25,6,2007/2008,31,29,21,8,-10.819778284410283
2007/2008,25,7,2007/2008,32,17,7,10,-11.512925464970229
2007/2008,25,8,2007/2008,33,12,19,7,-11.512925464970229
2007/2008,25,9,2007/2008,34,13,10,3,-11.512925464970229
2007/2008,25,10,2007/2008,35,17,13,4,-11.512925464970229
2007/2008,25,11,2007/2008,36,15,10,5,-10.819778284410283
2007/2008,25,12,2007/2008,37,14,8,6,-Inf
2007/2008,25,13,2007/2008,38,15,21,6,-Inf
2007/2008,25,14,2007/2008,39,10,11,1,-Inf
2007/2008,25,15,2007/2008,40,9,9,0,-0.4028086396469561
2007/2008,25,16,2007/2008,41,2,14,12,-Inf
2007/2008,25,17,2007/2008,42,6,14,8,-Inf
2007/2008,25,18,2007/2008,43,8,15,7,-Inf
2007/2008,25,19,2007/2008,44,5,18,13,-Inf
2007/2008,25,20,2007/2008,45,1,16,15,-Inf
2007/2008,25,21,2007/2008,46,2,12,10,-Inf
2007/2008,25,22,2007/2008,47,3,20,17,-Inf
2007/2008,25,23,2007/2008,48,4,8,4,-Inf
2007/2008,25,24,2007/2008,49,3,3,0,-0.3720351676235598
2007/2008,25,25,2007/2008,50,1,13,12,-Inf
2007/2008,25,26,2007/2008,51,3,4,1,-10.819778284410283
2007/2008,25,27,2007/2008,52,5,1,4,-Inf
2007/2008,25,28,2008/2009,1,2,10,8,-Inf
2007/2008,25,29,2008/2009,2,3,8,5,-Inf
2007/2008,25,30,2008/2009,3,2,13,11,-Inf
2007/2008,25,31,2008/2009,4,3,10,7,-Inf
2007/2008,25,32,2008/2009,5,2,21,19,-Inf
2007/2008,25,33,2008/2009,6,2,18,16,-Inf
2007/2008,25,34,2008/2009,7,3,21,18,-Inf
2007/2008,25,35,2008/2009,8,4,34,30,-Inf
2007/2008,25,36,2008/2009,9,3,25,22,-Inf
2007/2008,25,37,2008/2009,10,4,34,30,-Inf
2007/2008,25,38,2008/2009,11,4,33,29,-Inf
2007/2008,25,39,2008/2009,12,4,40,36,-Inf
2007/2008,25,40,2008/2009,13,7,42,35,-Inf
2007/2008,25,41,2008/2009,14,6,36,30,-Inf
2007/2008,25,42,2008/2009,15,15,72,57,-Inf
2007/2008,25,43,2008/2009,16,11,75,64,-Inf
2007/2008,25,44,2008/2009,17,9,76,67,-Inf
2007/2008,25,45,2008/2009,18,9,92,83,-Inf
2007/2008,25,46,2008/2009,19,12,71,59,-Inf
2007/2008,25,47,2008/2009,20,13,112,99,-Inf
2007/2008,25,48,2008/2009,21,13,106,93,-Inf
2007/2008,25,49,2008/2009,22,13,101,88,-Inf
2007/2008,25,50,2008/2009,23,20,170,150,-Inf
2007/2008,25,51,2008/2009,24,28,135,107,-Inf
2007/2008,25,52,2008/2009,25,45,106,61,-Inf
2007/2008,26,1,2007/2008,27,48,17,31,-Inf
2007/2008,26,2,2007/2008,28,48,19,29,-Inf
2007/2008,26,3,2007/2008,29,26,20,6,-10.819778284410283
2007/2008,26,4,2007/2008,30,33,12,21,-Inf
2007/2008,26,5,2007/2008,31,29,21,8,-Inf
2007/2008,26,6,2007/2008,32,17,7,10,-Inf
2007/2008,26,7,2007/2008,33,12,19,7,-Inf
2007/2008,26,8,2007/2008,34,13,10,3,-10.819778284410283
2007/2008,26,9,2007/2008,35,17,13,4,-10.819778284410283
2007/2008,26,10,2007/2008,36,15,10,5,-Inf
2007/2008,26,11,2007/2008,37,14,8,6,-Inf
2007/2008,26,12,2007/2008,38,15,21,6,-Inf
2007/2008,26,13,2007/2008,39,10,11,1,-Inf
2007/2008,26,14,2007/2008,40,9,9,0,-0.4089461599448203
2007/2008,26,15,2007/2008,41,2,14,12,-Inf
2007/2008,26,16,2007/2008,42,6,14,8,-Inf
2007/2008,26,17,2007/2008,43,8,15,7,-Inf
2007/2008,26,18,2007/2008,44,5,18,13,-Inf
2007/2008,26,19,2007/2008,45,1,16,15,-Inf
2007/2008,26,20,2007/2008,46,2,12,10,-Inf
2007/2008,26,21,2007/2008,47,3,20,17,-Inf
2007/2008,26,22,2007/2008,48,4,8,4,-Inf
2007/2008,26,23,2007/2008,49,3,3,0,-0.37438804153769745
2007/2008,26,24,2007/2008,50,1,13,12,-Inf
2007/2008,26,25,2007/2008,51,3,4,1,-Inf
2007/2008,26,26,2007/2008,52,5,1,4,-Inf
2007/2008,26,27,2008/2009,1,2,10,8,-Inf
2007/2008,26,28,2008/2009,2,3,8,5,-Inf
2007/2008,26,29,2008/2009,3,2,13,11,-Inf
2007/2008,26,30,2008/2009,4,3,10,7,-Inf
2007/2008,26,31,2008/2009,5,2,21,19,-Inf
2007/2008,26,32,2008/2009,6,2,18,16,-Inf
2007/2008,26,33,2008/2009,7,3,21,18,-Inf
2007/2008,26,34,2008/2009,8,4,34,30,-Inf
2007/2008,26,35,2008/2009,9,3,25,22,-Inf
2007/2008,26,36,2008/2009,10,4,34,30,-Inf
2007/2008,26,37,2008/2009,11,4,33,29,-Inf
2007/2008,26,38,2008/2009,12,4,40,36,-Inf
2007/2008,26,39,2008/2009,13,7,42,35,-Inf
2007/2008,26,40,2008/2009,14,6,36,30,-Inf
2007/2008,26,41,2008/2009,15,15,72,57,-Inf
2007/2008,26,42,2008/2009,16,11,75,64,-Inf
2007/2008,26,43,2008/2009,17,9,76,67,-Inf
2007/2008,26,44,2008/2009,18,9,92,83,-Inf
2007/2008,26,45,2008/2009,19,12,71,59,-Inf
2007/2008,26,46,2008/2009,20,13,112,99,-Inf
2007/2008,26,47,2008/2009,21,13,106,93,-Inf
2007/2008,26,48,2008/2009,22,13,101,88,-Inf
2007/2008,26,49,2008/2009,23,20,170,150,-Inf
2007/2008,26,50,2008/2009,24,28,135,107,-Inf
2007/2008,26,51,2008/2009,25,45,106,61,-11.512925464970229
2007/2008,26,52,2008/2009,26,28,68,40,-Inf
2007/2008,27,1,2007/2008,28,48,19,29,-Inf
2007/2008,27,2,2007/2008,29,26,20,6,-Inf
2007/2008,27,3,2007/2008,30,33,12,21,-11.512925464970229
2007/2008,27,4,2007/2008,31,29,21,8,-Inf
2007/2008,27,5,2007/2008,32,17,7,10,-11.512925464970229
2007/2008,27,6,2007/2008,33,12,19,7,-Inf
2007/2008,27,7,2007/2008,34,13,10,3,-Inf
2007/2008,27,8,2007/2008,35,17,13,4,-Inf
2007/2008,27,9,2007/2008,36,15,10,5,-Inf
2007/2008,27,10,2007/2008,37,14,8,6,-11.512925464970229
2007/2008,27,11,2007/2008,38,15,21,6,-Inf
2007/2008,27,12,2007/2008,39,10,11,1,-Inf
2007/2008,27,13,2007/2008,40,9,9,0,-0.4122480604049965
2007/2008,27,14,2007/2008,41,2,14,12,-Inf
2007/2008,27,15,2007/2008,42,6,14,8,-Inf
2007/2008,27,16,2007/2008,43,8,15,7,-Inf
2007/2008,27,17,2007/2008,44,5,18,13,-Inf
2007/2008,27,18,2007/2008,45,1,16,15,-11.512925464970229
2007/2008,27,19,2007/2008,46,2,12,10,-Inf
2007/2008,27,20,2007/2008,47,3,20,17,-Inf
2007/2008,27,21,2007/2008,48,4,8,4,-Inf
2007/2008,27,22,2007/2008,49,3,3,0,-0.37792776511507675
2007/2008,27,23,2007/2008,50,1,13,12,-Inf
2007/2008,27,24,2007/2008,51,3,4,1,-10.819778284410283
2007/2008,27,25,2007/2008,52,5,1,4,-Inf
2007/2008,27,26,2008/2009,1,2,10,8,-Inf
2007/2008,27,27,2008/2009,2,3,8,5,-Inf
2007/2008,27,28,2008/2009,3,2,13,11,-Inf
2007/2008,27,29,2008/2009,4,3,10,7,-Inf
2007/2008,27,30,2008/2009,5,2,21,19,-Inf
2007/2008,27,31,2008/2009,6,2,18,16,-Inf
2007/2008,27,32,2008/2009,7,3,21,18,-Inf
2007/2008,27,33,2008/2009,8,4,34,30,-Inf
2007/2008,27,34,2008/2009,9,3,25,22,-Inf
2007/2008,27,35,2008/2009,10,4,34,30,-Inf
2007/2008,27,36,2008/2009,11,4,33,29,-Inf
2007/2008,27,37,2008/2009,12,4,40,36,-Inf
2007/2008,27,38,2008/2009,13,7,42,35,-Inf
2007/2008,27,39,2008/2009,14,6,36,30,-Inf
2007/2008,27,40,2008/2009,15,15,72,57,-Inf
2007/2008,27,41,2008/2009,16,11,75,64,-Inf
2007/2008,27,42,2008/2009,17,9,76,67,-Inf
2007/2008,27,43,2008/2009,18,9,92,83,-Inf
2007/2008,27,44,2008/2009,19,12,71,59,-Inf
2007/2008,27,45,2008/2009,20,13,112,99,-Inf
2007/2008,27,46,2008/2009,21,13,106,93,-Inf
2007/2008,27,47,2008/2009,22,13,101,88,-Inf
2007/2008,27,48,2008/2009,23,20,170,150,-Inf
2007/2008,27,49,2008/2009,24,28,135,107,-Inf
2007/2008,27,50,2008/2009,25,45,106,61,-Inf
2007/2008,27,51,2008/2009,26,28,68,40,-Inf
2007/2008,27,52,2008/2009,27,34,48,14,-11.512925464970229
2007/2008,28,1,2007/2008,29,26,20,6,-Inf
2007/2008,28,2,2007/2008,30,33,12,21,-Inf
2007/2008,28,3,2007/2008,31,29,21,8,-11.512925464970229
2007/2008,28,4,2007/2008,32,17,7,10,-11.512925464970229
2007/2008,28,5,2007/2008,33,12,19,7,-Inf
2007/2008,28,6,2007/2008,34,13,10,3,-11.512925464970229
2007/2008,28,7,2007/2008,35,17,13,4,-Inf
2007/2008,28,8,2007/2008,36,15,10,5,-11.512925464970229
2007/2008,28,9,2007/2008,37,14,8,6,-Inf
2007/2008,28,10,2007/2008,38,15,21,6,-Inf
2007/2008,28,11,2007/2008,39,10,11,1,-Inf
2007/2008,28,12,2007/2008,40,9,9,0,-0.419310514930217
2007/2008,28,13,2007/2008,41,2,14,12,-Inf
2007/2008,28,14,2007/2008,42,6,14,8,-Inf
2007/2008,28,15,2007/2008,43,8,15,7,-Inf
2007/2008,28,16,2007/2008,44,5,18,13,-Inf
2007/2008,28,17,2007/2008,45,1,16,15,-Inf
2007/2008,28,18,2007/2008,46,2,12,10,-Inf
2007/2008,28,19,2007/2008,47,3,20,17,-Inf
2007/2008,28,20,2007/2008,48,4,8,4,-11.512925464970229
2007/2008,28,21,2007/2008,49,3,3,0,-0.3808651827399494
2007/2008,28,22,2007/2008,50,1,13,12,-Inf
2007/2008,28,23,2007/2008,51,3,4,1,-Inf
2007/2008,28,24,2007/2008,52,5,1,4,-Inf
2007/2008,28,25,2008/2009,1,2,10,8,-Inf
2007/2008,28,26,2008/2009,2,3,8,5,-Inf
2007/2008,28,27,2008/2009,3,2,13,11,-Inf
2007/2008,28,28,2008/2009,4,3,10,7,-Inf
2007/2008,28,29,2008/2009,5,2,21,19,-Inf
2007/2008,28,30,2008/2009,6,2,18,16,-Inf
2007/2008,28,31,2008/2009,7,3,21,18,-Inf
2007/2008,28,32,2008/2009,8,4,34,30,-Inf
2007/2008,28,33,2008/2009,9,3,25,22,-Inf
2007/2008,28,34,2008/2009,10,4,34,30,-Inf
2007/2008,28,35,2008/2009,11,4,33,29,-Inf
2007/2008,28,36,2008/2009,12,4,40,36,-Inf
2007/2008,28,37,2008/2009,13,7,42,35,-Inf
2007/2008,28,38,2008/2009,14,6,36,30,-Inf
2007/2008,28,39,2008/2009,15,15,72,57,-Inf
2007/2008,28,40,2008/2009,16,11,75,64,-Inf
2007/2008,28,41,2008/2009,17,9,76,67,-Inf
2007/2008,28,42,2008/2009,18,9,92,83,-Inf
2007/2008,28,43,2008/2009,19,12,71,59,-Inf
2007/2008,28,44,2008/2009,20,13,112,99,-Inf
2007/2008,28,45,2008/2009,21,13,106,93,-Inf
2007/2008,28,46,2008/2009,22,13,101,88,-Inf
2007/2008,28,47,2008/2009,23,20,170,150,-Inf
2007/2008,28,48,2008/2009,24,28,135,107,-Inf
2007/2008,28,49,2008/2009,25,45,106,61,-Inf
2007/2008,28,50,2008/2009,26,28,68,40,-Inf
2007/2008,28,51,2008/2009,27,34,48,14,-Inf
2007/2008,28,52,2008/2009,28,41,48,7,-Inf
2007/2008,29,1,2007/2008,30,33,12,21,-Inf
2007/2008,29,2,2007/2008,31,29,21,8,-Inf
2007/2008,29,3,2007/2008,32,17,7,10,-Inf
2007/2008,29,4,2007/2008,33,12,19,7,-Inf
2007/2008,29,5,2007/2008,34,13,10,3,-11.512925464970229
2007/2008,29,6,2007/2008,35,17,13,4,-Inf
2007/2008,29,7,2007/2008,36,15,10,5,-Inf
2007/2008,29,8,2007/2008,37,14,8,6,-11.512925464970229
2007/2008,29,9,2007/2008,38,15,21,6,-Inf
2007/2008,29,10,2007/2008,39,10,11,1,-Inf
2007/2008,29,11,2007/2008,40,9,9,0,-0.42873885276788215
2007/2008,29,12,2007/2008,41,2,14,12,-Inf
2007/2008,29,13,2007/2008,42,6,14,8,-Inf
2007/2008,29,14,2007/2008,43,8,15,7,-Inf
2007/2008,29,15,2007/2008,44,5,18,13,-Inf
2007/2008,29,16,2007/2008,45,1,16,15,-Inf
2007/2008,29,17,2007/2008,46,2,12,10,-Inf
2007/2008,29,18,2007/2008,47,3,20,17,-Inf
2007/2008,29,19,2007/2008,48,4,8,4,-Inf
2007/2008,29,20,2007/2008,49,3,3,0,-0.3833416466205417
2007/2008,29,21,2007/2008,50,1,13,12,-Inf
2007/2008,29,22,2007/2008,51,3,4,1,-Inf
2007/2008,29,23,2007/2008,52,5,1,4,-10.819778284410283
2007/2008,29,24,2008/2009,1,2,10,8,-Inf
2007/2008,29,25,2008/2009,2,3,8,5,-Inf
2007/2008,29,26,2008/2009,3,2,13,11,-11.512925464970229
2007/2008,29,27,2008/2009,4,3,10,7,-Inf
2007/2008,29,28,2008/2009,5,2,21,19,-Inf
2007/2008,29,29,2008/2009,6,2,18,16,-Inf
2007/2008,29,30,2008/2009,7,3,21,18,-Inf
2007/2008,29,31,2008/2009,8,4,34,30,-Inf
2007/2008,29,32,2008/2009,9,3,25,22,-Inf
2007/2008,29,33,2008/2009,10,4,34,30,-Inf
2007/2008,29,34,2008/2009,11,4,33,29,-Inf
2007/2008,29,35,2008/2009,12,4,40,36,-Inf
2007/2008,29,36,2008/2009,13,7,42,35,-Inf
2007/2008,29,37,2008/2009,14,6,36,30,-Inf
2007/2008,29,38,2008/2009,15,15,72,57,-Inf
2007/2008,29,39,2008/2009,16,11,75,64,-Inf
2007/2008,29,40,2008/2009,17,9,76,67,-Inf
2007/2008,29,41,2008/2009,18,9,92,83,-Inf
2007/2008,29,42,2008/2009,19,12,71,59,-Inf
2007/2008,29,43,2008/2009,20,13,112,99,-Inf
2007/2008,29,44,2008/2009,21,13,106,93,-Inf
2007/2008,29,45,2008/2009,22,13,101,88,-Inf
2007/2008,29,46,2008/2009,23,20,170,150,-Inf
2007/2008,29,47,2008/2009,24,28,135,107,-Inf
2007/2008,29,48,2008/2009,25,45,106,61,-Inf
2007/2008,29,49,2008/2009,26,28,68,40,-Inf
2007/2008,29,50,2008/2009,27,34,48,14,-Inf
2007/2008,29,51,2008/2009,28,41,48,7,-Inf
2007/2008,29,52,2008/2009,29,36,26,10,-Inf
2007/2008,2,1,2007/2008,3,13,3,10,-Inf
2007/2008,2,2,2007/2008,4,10,5,5,-Inf
2007/2008,2,3,2007/2008,5,21,11,10,-Inf
2007/2008,2,4,2007/2008,6,18,5,13,-Inf
2007/2008,2,5,2007/2008,7,21,5,16,-Inf
2007/2008,2,6,2007/2008,8,34,6,28,-Inf
2007/2008,2,7,2007/2008,9,25,6,19,-Inf
2007/2008,2,8,2007/2008,10,34,4,30,-11.512925464970229
2007/2008,2,9,2007/2008,11,33,4,29,-Inf
2007/2008,2,10,2007/2008,12,40,8,32,-Inf
2007/2008,2,11,2007/2008,13,42,14,28,-Inf
2007/2008,2,12,2007/2008,14,36,12,24,-Inf
2007/2008,2,13,2007/2008,15,72,16,56,-Inf
2007/2008,2,14,2007/2008,16,75,10,65,-Inf
2007/2008,2,15,2007/2008,17,76,16,60,-Inf
2007/2008,2,16,2007/2008,18,92,18,74,-Inf
2007/2008,2,17,2007/2008,19,71,15,56,-Inf
2007/2008,2,18,2007/2008,20,112,23,89,-Inf
2007/2008,2,19,2007/2008,21,106,17,89,-Inf
2007/2008,2,20,2007/2008,22,101,33,68,-Inf
2007/2008,2,21,2007/2008,23,170,15,155,-Inf
2007/2008,2,22,2007/2008,24,135,13,122,-Inf
2007/2008,2,23,2007/2008,25,106,11,95,-Inf
2007/2008,2,24,2007/2008,26,68,14,54,-Inf
2007/2008,2,25,2007/2008,27,48,17,31,-Inf
2007/2008,2,26,2007/2008,28,48,19,29,-Inf
2007/2008,2,27,2007/2008,29,26,20,6,-Inf
2007/2008,2,28,2007/2008,30,33,12,21,-Inf
2007/2008,2,29,2007/2008,31,29,21,8,-Inf
2007/2008,2,30,2007/2008,32,17,7,10,-Inf
2007/2008,2,31,2007/2008,33,12,19,7,-Inf
2007/2008,2,32,2007/2008,34,13,10,3,-Inf
2007/2008,2,33,2007/2008,35,17,13,4,-Inf
2007/2008,2,34,2007/2008,36,15,10,5,-Inf
2007/2008,2,35,2007/2008,37,14,8,6,-11.512925464970229
2007/2008,2,36,2007/2008,38,15,21,6,-Inf
2007/2008,2,37,2007/2008,39,10,11,1,-10.819778284410283
2007/2008,2,38,2007/2008,40,9,9,0,-0.33783917044971723
2007/2008,2,39,2007/2008,41,2,14,12,-Inf
2007/2008,2,40,2007/2008,42,6,14,8,-Inf
2007/2008,2,41,2007/2008,43,8,15,7,-Inf
2007/2008,2,42,2007/2008,44,5,18,13,-Inf
2007/2008,2,43,2007/2008,45,1,16,15,-Inf
2007/2008,2,44,2007/2008,46,2,12,10,-Inf
2007/2008,2,45,2007/2008,47,3,20,17,-Inf
2007/2008,2,46,2007/2008,48,4,8,4,-Inf
2007/2008,2,47,2007/2008,49,3,3,0,-0.34563609682351704
2007/2008,2,48,2007/2008,50,1,13,12,-Inf
2007/2008,2,49,2007/2008,51,3,4,1,-11.512925464970229
2007/2008,2,50,2007/2008,52,5,1,4,-Inf
2007/2008,2,51,2008/2009,1,2,10,8,-Inf
2007/2008,2,52,2008/2009,2,3,8,5,-Inf
2007/2008,30,1,2007/2008,31,29,21,8,-Inf
2007/2008,30,2,2007/2008,32,17,7,10,-Inf
2007/2008,30,3,2007/2008,33,12,19,7,-Inf
2007/2008,30,4,2007/2008,34,13,10,3,-Inf
2007/2008,30,5,2007/2008,35,17,13,4,-11.512925464970229
2007/2008,30,6,2007/2008,36,15,10,5,-Inf
2007/2008,30,7,2007/2008,37,14,8,6,-Inf
2007/2008,30,8,2007/2008,38,15,21,6,-Inf
2007/2008,30,9,2007/2008,39,10,11,1,-Inf
2007/2008,30,10,2007/2008,40,9,9,0,-0.43280033432822407
2007/2008,30,11,2007/2008,41,2,14,12,-Inf
2007/2008,30,12,2007/2008,42,6,14,8,-Inf
2007/2008,30,13,2007/2008,43,8,15,7,-Inf
2007/2008,30,14,2007/2008,44,5,18,13,-Inf
2007/2008,30,15,2007/2008,45,1,16,15,-Inf
2007/2008,30,16,2007/2008,46,2,12,10,-Inf
2007/2008,30,17,2007/2008,47,3,20,17,-Inf
2007/2008,30,18,2007/2008,48,4,8,4,-Inf
2007/2008,30,19,2007/2008,49,3,3,0,-0.38557424941037155
2007/2008,30,20,2007/2008,50,1,13,12,-Inf
2007/2008,30,21,2007/2008,51,3,4,1,-11.512925464970229
2007/2008,30,22,2007/2008,52,5,1,4,-11.512925464970229
2007/2008,30,23,2008/2009,1,2,10,8,-Inf
2007/2008,30,24,2008/2009,2,3,8,5,-Inf
2007/2008,30,25,2008/2009,3,2,13,11,-Inf
2007/2008,30,26,2008/2009,4,3,10,7,-Inf
2007/2008,30,27,2008/2009,5,2,21,19,-Inf
2007/2008,30,28,2008/2009,6,2,18,16,-Inf
2007/2008,30,29,2008/2009,7,3,21,18,-Inf
2007/2008,30,30,2008/2009,8,4,34,30,-Inf
2007/2008,30,31,2008/2009,9,3,25,22,-Inf
2007/2008,30,32,2008/2009,10,4,34,30,-Inf
2007/2008,30,33,2008/2009,11,4,33,29,-Inf
2007/2008,30,34,2008/2009,12,4,40,36,-Inf
2007/2008,30,35,2008/2009,13,7,42,35,-Inf
2007/2008,30,36,2008/2009,14,6,36,30,-Inf
2007/2008,30,37,2008/2009,15,15,72,57,-Inf
2007/2008,30,38,2008/2009,16,11,75,64,-Inf
2007/2008,30,39,2008/2009,17,9,76,67,-Inf
2007/2008,30,40,2008/2009,18,9,92,83,-Inf
2007/2008,30,41,2008/2009,19,12,71,59,-Inf
2007/2008,30,42,2008/2009,20,13,112,99,-Inf
2007/2008,30,43,2008/2009,21,13,106,93,-Inf
2007/2008,30,44,2008/2009,22,13,101,88,-Inf
2007/2008,30,45,2008/2009,23,20,170,150,-Inf
2007/2008,30,46,2008/2009,24,28,135,107,-Inf
2007/2008,30,47,2008/2009,25,45,106,61,-Inf
2007/2008,30,48,2008/2009,26,28,68,40,-Inf
2007/2008,30,49,2008/2009,27,34,48,14,-Inf
2007/2008,30,50,2008/2009,28,41,48,7,-Inf
2007/2008,30,51,2008/2009,29,36,26,10,-Inf
2007/2008,30,52,2008/2009,30,38,33,5,-Inf
2007/2008,31,1,2007/2008,32,17,7,10,-Inf
2007/2008,31,2,2007/2008,33,12,19,7,-Inf
2007/2008,31,3,2007/2008,34,13,10,3,-11.512925464970229
2007/2008,31,4,2007/2008,35,17,13,4,-10.819778284410283
2007/2008,31,5,2007/2008,36,15,10,5,-11.512925464970229
2007/2008,31,6,2007/2008,37,14,8,6,-Inf
2007/2008,31,7,2007/2008,38,15,21,6,-Inf
2007/2008,31,8,2007/2008,39,10,11,1,-Inf
2007/2008,31,9,2007/2008,40,9,9,0,-0.4430890967048544
2007/2008,31,10,2007/2008,41,2,14,12,-Inf
2007/2008,31,11,2007/2008,42,6,14,8,-Inf
2007/2008,31,12,2007/2008,43,8,15,7,-Inf
2007/2008,31,13,2007/2008,44,5,18,13,-Inf
2007/2008,31,14,2007/2008,45,1,16,15,-Inf
2007/2008,31,15,2007/2008,46,2,12,10,-Inf
2007/2008,31,16,2007/2008,47,3,20,17,-Inf
2007/2008,31,17,2007/2008,48,4,8,4,-Inf
2007/2008,31,18,2007/2008,49,3,3,0,-0.38688381457181364
2007/2008,31,19,2007/2008,50,1,13,12,-Inf
2007/2008,31,20,2007/2008,51,3,4,1,-11.512925464970229
2007/2008,31,21,2007/2008,52,5,1,4,-11.512925464970229
2007/2008,31,22,2008/2009,1,2,10,8,-Inf
2007/2008,31,23,2008/2009,2,3,8,5,-Inf
2007/2008,31,24,2008/2009,3,2,13,11,-Inf
2007/2008,31,25,2008/2009,4,3,10,7,-11.512925464970229
2007/2008,31,26,2008/2009,5,2,21,19,-Inf
2007/2008,31,27,2008/2009,6,2,18,16,-Inf
2007/2008,31,28,2008/2009,7,3,21,18,-Inf
2007/2008,31,29,2008/2009,8,4,34,30,-Inf
2007/2008,31,30,2008/2009,9,3,25,22,-Inf
2007/2008,31,31,2008/2009,10,4,34,30,-Inf
2007/2008,31,32,2008/2009,11,4,33,29,-Inf
2007/2008,31,33,2008/2009,12,4,40,36,-Inf
2007/2008,31,34,2008/2009,13,7,42,35,-Inf
2007/2008,31,35,2008/2009,14,6,36,30,-Inf
2007/2008,31,36,2008/2009,15,15,72,57,-Inf
2007/2008,31,37,2008/2009,16,11,75,64,-Inf
2007/2008,31,38,2008/2009,17,9,76,67,-Inf
2007/2008,31,39,2008/2009,18,9,92,83,-Inf
2007/2008,31,40,2008/2009,19,12,71,59,-Inf
2007/2008,31,41,2008/2009,20,13,112,99,-Inf
2007/2008,31,42,2008/2009,21,13,106,93,-Inf
2007/2008,31,43,2008/2009,22,13,101,88,-Inf
2007/2008,31,44,2008/2009,23,20,170,150,-Inf
2007/2008,31,45,2008/2009,24,28,135,107,-Inf
2007/2008,31,46,2008/2009,25,45,106,61,-Inf
2007/2008,31,47,2008/2009,26,28,68,40,-Inf
2007/2008,31,48,2008/2009,27,34,48,14,-Inf
2007/2008,31,49,2008/2009,28,41,48,7,-Inf
2007/2008,31,50,2008/2009,29,36,26,10,-Inf
2007/2008,31,51,2008/2009,30,38,33,5,-Inf
2007/2008,31,52,2008/2009,31,48,29,19,-Inf
2007/2008,32,1,2007/2008,33,12,19,7,-Inf
2007/2008,32,2,2007/2008,34,13,10,3,-Inf
2007/2008,32,3,2007/2008,35,17,13,4,-11.512925464970229
2007/2008,32,4,2007/2008,36,15,10,5,-Inf
2007/2008,32,5,2007/2008,37,14,8,6,-11.512925464970229
2007/2008,32,6,2007/2008,38,15,21,6,-Inf
2007/2008,32,7,2007/2008,39,10,11,1,-Inf
2007/2008,32,8,2007/2008,40,9,9,0,-0.45357925083159323
2007/2008,32,9,2007/2008,41,2,14,12,-Inf
2007/2008,32,10,2007/2008,42,6,14,8,-Inf
2007/2008,32,11,2007/2008,43,8,15,7,-Inf
2007/2008,32,12,2007/2008,44,5,18,13,-Inf
2007/2008,32,13,2007/2008,45,1,16,15,-Inf
2007/2008,32,14,2007/2008,46,2,12,10,-Inf
2007/2008,32,15,2007/2008,47,3,20,17,-Inf
2007/2008,32,16,2007/2008,48,4,8,4,-Inf
2007/2008,32,17,2007/2008,49,3,3,0,-0.3904237979136962
2007/2008,32,18,2007/2008,50,1,13,12,-Inf
2007/2008,32,19,2007/2008,51,3,4,1,-10.819778284410283
2007/2008,32,20,2007/2008,52,5,1,4,-11.512925464970229
2007/2008,32,21,2008/2009,1,2,10,8,-Inf
2007/2008,32,22,2008/2009,2,3,8,5,-Inf
2007/2008,32,23,2008/2009,3,2,13,11,-Inf
2007/2008,32,24,2008/2009,4,3,10,7,-Inf
2007/2008,32,25,2008/2009,5,2,21,19,-Inf
2007/2008,32,26,2008/2009,6,2,18,16,-Inf
2007/2008,32,27,2008/2009,7,3,21,18,-Inf
2007/2008,32,28,2008/2009,8,4,34,30,-Inf
2007/2008,32,29,2008/2009,9,3,25,22,-Inf
2007/2008,32,30,2008/2009,10,4,34,30,-Inf
2007/2008,32,31,2008/2009,11,4,33,29,-Inf
2007/2008,32,32,2008/2009,12,4,40,36,-Inf
2007/2008,32,33,2008/2009,13,7,42,35,-Inf
2007/2008,32,34,2008/2009,14,6,36,30,-Inf
2007/2008,32,35,2008/2009,15,15,72,57,-Inf
2007/2008,32,36,2008/2009,16,11,75,64,-Inf
2007/2008,32,37,2008/2009,17,9,76,67,-Inf
2007/2008,32,38,2008/2009,18,9,92,83,-Inf
2007/2008,32,39,2008/2009,19,12,71,59,-Inf
2007/2008,32,40,2008/2009,20,13,112,99,-Inf
2007/2008,32,41,2008/2009,21,13,106,93,-Inf
2007/2008,32,42,2008/2009,22,13,101,88,-Inf
2007/2008,32,43,2008/2009,23,20,170,150,-Inf
2007/2008,32,44,2008/2009,24,28,135,107,-Inf
2007/2008,32,45,2008/2009,25,45,106,61,-Inf
2007/2008,32,46,2008/2009,26,28,68,40,-Inf
2007/2008,32,47,2008/2009,27,34,48,14,-Inf
2007/2008,32,48,2008/2009,28,41,48,7,-Inf
2007/2008,32,49,2008/2009,29,36,26,10,-Inf
2007/2008,32,50,2008/2009,30,38,33,5,-Inf
2007/2008,32,51,2008/2009,31,48,29,19,-Inf
2007/2008,32,52,2008/2009,32,27,17,10,-Inf
2007/2008,33,1,2007/2008,34,13,10,3,-Inf
2007/2008,33,2,2007/2008,35,17,13,4,-Inf
2007/2008,33,3,2007/2008,36,15,10,5,-10.819778284410283
2007/2008,33,4,2007/2008,37,14,8,6,-Inf
2007/2008,33,5,2007/2008,38,15,21,6,-Inf
2007/2008,33,6,2007/2008,39,10,11,1,-11.512925464970229
2007/2008,33,7,2007/2008,40,9,9,0,-0.1930145233327547
2007/2008,33,8,2007/2008,41,2,14,12,-Inf
2007/2008,33,9,2007/2008,42,6,14,8,-Inf
2007/2008,33,10,2007/2008,43,8,15,7,-Inf
2007/2008,33,11,2007/2008,44,5,18,13,-Inf
2007/2008,33,12,2007/2008,45,1,16,15,-Inf
2007/2008,33,13,2007/2008,46,2,12,10,-Inf
2007/2008,33,14,2007/2008,47,3,20,17,-Inf
2007/2008,33,15,2007/2008,48,4,8,4,-11.512925464970229
2007/2008,33,16,2007/2008,49,3,3,0,-0.26197534010837487
2007/2008,33,17,2007/2008,50,1,13,12,-Inf
2007/2008,33,18,2007/2008,51,3,4,1,-Inf
2007/2008,33,19,2007/2008,52,5,1,4,-Inf
2007/2008,33,20,2008/2009,1,2,10,8,-Inf
2007/2008,33,21,2008/2009,2,3,8,5,-Inf
2007/2008,33,22,2008/2009,3,2,13,11,-Inf
2007/2008,33,23,2008/2009,4,3,10,7,-Inf
2007/2008,33,24,2008/2009,5,2,21,19,-Inf
2007/2008,33,25,2008/2009,6,2,18,16,-Inf
2007/2008,33,26,2008/2009,7,3,21,18,-Inf
2007/2008,33,27,2008/2009,8,4,34,30,-Inf
2007/2008,33,28,2008/2009,9,3,25,22,-Inf
2007/2008,33,29,2008/2009,10,4,34,30,-Inf
2007/2008,33,30,2008/2009,11,4,33,29,-Inf
2007/2008,33,31,2008/2009,12,4,40,36,-Inf
2007/2008,33,32,2008/2009,13,7,42,35,-Inf
2007/2008,33,33,2008/2009,14,6,36,30,-Inf
2007/2008,33,34,2008/2009,15,15,72,57,-Inf
2007/2008,33,35,2008/2009,16,11,75,64,-Inf
2007/2008,33,36,2008/2009,17,9,76,67,-Inf
2007/2008,33,37,2008/2009,18,9,92,83,-Inf
2007/2008,33,38,2008/2009,19,12,71,59,-Inf
2007/2008,33,39,2008/2009,20,13,112,99,-Inf
2007/2008,33,40,2008/2009,21,13,106,93,-Inf
2007/2008,33,41,2008/2009,22,13,101,88,-Inf
2007/2008,33,42,2008/2009,23,20,170,150,-Inf
2007/2008,33,43,2008/2009,24,28,135,107,-Inf
2007/2008,33,44,2008/2009,25,45,106,61,-Inf
2007/2008,33,45,2008/2009,26,28,68,40,-Inf
2007/2008,33,46,2008/2009,27,34,48,14,-Inf
2007/2008,33,47,2008/2009,28,41,48,7,-11.512925464970229
2007/2008,33,48,2008/2009,29,36,26,10,-Inf
2007/2008,33,49,2008/2009,30,38,33,5,-11.512925464970229
2007/2008,33,50,2008/2009,31,48,29,19,-Inf
2007/2008,33,51,2008/2009,32,27,17,10,-Inf
2007/2008,33,52,2008/2009,33,23,12,11,-Inf
2007/2008,34,1,2007/2008,35,17,13,4,-Inf
2007/2008,34,2,2007/2008,36,15,10,5,-Inf
2007/2008,34,3,2007/2008,37,14,8,6,-Inf
2007/2008,34,4,2007/2008,38,15,21,6,-Inf
2007/2008,34,5,2007/2008,39,10,11,1,-Inf
2007/2008,34,6,2007/2008,40,9,9,0,-0.2492180557774919
2007/2008,34,7,2007/2008,41,2,14,12,-Inf
2007/2008,34,8,2007/2008,42,6,14,8,-Inf
2007/2008,34,9,2007/2008,43,8,15,7,-Inf
2007/2008,34,10,2007/2008,44,5,18,13,-Inf
2007/2008,34,11,2007/2008,45,1,16,15,-Inf
2007/2008,34,12,2007/2008,46,2,12,10,-Inf
2007/2008,34,13,2007/2008,47,3,20,17,-Inf
2007/2008,34,14,2007/2008,48,4,8,4,-Inf
2007/2008,34,15,2007/2008,49,3,3,0,-0.2870689271304645
2007/2008,34,16,2007/2008,50,1,13,12,-Inf
2007/2008,34,17,2007/2008,51,3,4,1,-Inf
2007/2008,34,18,2007/2008,52,5,1,4,-Inf
2007/2008,34,19,2008/2009,1,2,10,8,-Inf
2007/2008,34,20,2008/2009,2,3,8,5,-11.512925464970229
2007/2008,34,21,2008/2009,3,2,13,11,-Inf
2007/2008,34,22,2008/2009,4,3,10,7,-Inf
2007/2008,34,23,2008/2009,5,2,21,19,-Inf
2007/2008,34,24,2008/2009,6,2,18,16,-Inf
2007/2008,34,25,2008/2009,7,3,21,18,-Inf
2007/2008,34,26,2008/2009,8,4,34,30,-Inf
2007/2008,34,27,2008/2009,9,3,25,22,-Inf
2007/2008,34,28,2008/2009,10,4,34,30,-Inf
2007/2008,34,29,2008/2009,11,4,33,29,-Inf
2007/2008,34,30,2008/2009,12,4,40,36,-Inf
2007/2008,34,31,2008/2009,13,7,42,35,-Inf
2007/2008,34,32,2008/2009,14,6,36,30,-Inf
2007/2008,34,33,2008/2009,15,15,72,57,-Inf
2007/2008,34,34,2008/2009,16,11,75,64,-Inf
2007/2008,34,35,2008/2009,17,9,76,67,-Inf
2007/2008,34,36,2008/2009,18,9,92,83,-Inf
2007/2008,34,37,2008/2009,19,12,71,59,-Inf
2007/2008,34,38,2008/2009,20,13,112,99,-Inf
2007/2008,34,39,2008/2009,21,13,106,93,-Inf
2007/2008,34,40,2008/2009,22,13,101,88,-Inf
2007/2008,34,41,2008/2009,23,20,170,150,-Inf
2007/2008,34,42,2008/2009,24,28,135,107,-Inf
2007/2008,34,43,2008/2009,25,45,106,61,-Inf
2007/2008,34,44,2008/2009,26,28,68,40,-Inf
2007/2008,34,45,2008/2009,27,34,48,14,-Inf
2007/2008,34,46,2008/2009,28,41,48,7,-Inf
2007/2008,34,47,2008/2009,29,36,26,10,-Inf
2007/2008,34,48,2008/2009,30,38,33,5,-Inf
2007/2008,34,49,2008/2009,31,48,29,19,-Inf
2007/2008,34,50,2008/2009,32,27,17,10,-Inf
2007/2008,34,51,2008/2009,33,23,12,11,-Inf
2007/2008,34,52,2008/2009,34,28,13,15,-Inf
2007/2008,35,1,2007/2008,36,15,10,5,-11.512925464970229
2007/2008,35,2,2007/2008,37,14,8,6,-11.512925464970229
2007/2008,35,3,2007/2008,38,15,21,6,-Inf
2007/2008,35,4,2007/2008,39,10,11,1,-Inf
2007/2008,35,5,2007/2008,40,9,9,0,-0.3105277250566427
2007/2008,35,6,2007/2008,41,2,14,12,-Inf
2007/2008,35,7,2007/2008,42,6,14,8,-Inf
2007/2008,35,8,2007/2008,43,8,15,7,-Inf
2007/2008,35,9,2007/2008,44,5,18,13,-Inf
2007/2008,35,10,2007/2008,45,1,16,15,-Inf
2007/2008,35,11,2007/2008,46,2,12,10,-Inf
2007/2008,35,12,2007/2008,47,3,20,17,-Inf
2007/2008,35,13,2007/2008,48,4,8,4,-Inf
2007/2008,35,14,2007/2008,49,3,3,0,-0.30906915433342874
2007/2008,35,15,2007/2008,50,1,13,12,-Inf
2007/2008,35,16,2007/2008,51,3,4,1,-10.819778284410283
2007/2008,35,17,2007/2008,52,5,1,4,-Inf
2007/2008,35,18,2008/2009,1,2,10,8,-Inf
2007/2008,35,19,2008/2009,2,3,8,5,-Inf
2007/2008,35,20,2008/2009,3,2,13,11,-Inf
2007/2008,35,21,2008/2009,4,3,10,7,-Inf
2007/2008,35,22,2008/2009,5,2,21,19,-Inf
2007/2008,35,23,2008/2009,6,2,18,16,-Inf
2007/2008,35,24,2008/2009,7,3,21,18,-Inf
2007/2008,35,25,2008/2009,8,4,34,30,-Inf
2007/2008,35,26,2008/2009,9,3,25,22,-Inf
2007/2008,35,27,2008/2009,10,4,34,30,-Inf
2007/2008,35,28,2008/2009,11,4,33,29,-Inf
2007/2008,35,29,2008/2009,12,4,40,36,-Inf
2007/2008,35,30,2008/2009,13,7,42,35,-Inf
2007/2008,35,31,2008/2009,14,6,36,30,-Inf
2007/2008,35,32,2008/2009,15,15,72,57,-Inf
2007/2008,35,33,2008/2009,16,11,75,64,-Inf
2007/2008,35,34,2008/2009,17,9,76,67,-Inf
2007/2008,35,35,2008/2009,18,9,92,83,-Inf
2007/2008,35,36,2008/2009,19,12,71,59,-Inf
2007/2008,35,37,2008/2009,20,13,112,99,-Inf
2007/2008,35,38,2008/2009,21,13,106,93,-Inf
2007/2008,35,39,2008/2009,22,13,101,88,-Inf
2007/2008,35,40,2008/2009,23,20,170,150,-Inf
2007/2008,35,41,2008/2009,24,28,135,107,-Inf
2007/2008,35,42,2008/2009,25,45,106,61,-Inf
2007/2008,35,43,2008/2009,26,28,68,40,-Inf
2007/2008,35,44,2008/2009,27,34,48,14,-Inf
2007/2008,35,45,2008/2009,28,41,48,7,-Inf
2007/2008,35,46,2008/2009,29,36,26,10,-Inf
2007/2008,35,47,2008/2009,30,38,33,5,-Inf
2007/2008,35,48,2008/2009,31,48,29,19,-Inf
2007/2008,35,49,2008/2009,32,27,17,10,-Inf
2007/2008,35,50,2008/2009,33,23,12,11,-Inf
2007/2008,35,51,2008/2009,34,28,13,15,-Inf
2007/2008,35,52,2008/2009,35,42,17,25,-Inf
2007/2008,36,1,2007/2008,37,14,8,6,-11.512925464970229
2007/2008,36,2,2007/2008,38,15,21,6,-Inf
2007/2008,36,3,2007/2008,39,10,11,1,-Inf
2007/2008,36,4,2007/2008,40,9,9,0,-0.3788767326367086
2007/2008,36,5,2007/2008,41,2,14,12,-Inf
2007/2008,36,6,2007/2008,42,6,14,8,-Inf
2007/2008,36,7,2007/2008,43,8,15,7,-Inf
2007/2008,36,8,2007/2008,44,5,18,13,-Inf
2007/2008,36,9,2007/2008,45,1,16,15,-Inf
2007/2008,36,10,2007/2008,46,2,12,10,-Inf
2007/2008,36,11,2007/2008,47,3,20,17,-11.512925464970229
2007/2008,36,12,2007/2008,48,4,8,4,-Inf
2007/2008,36,13,2007/2008,49,3,3,0,-0.3372785616138536
2007/2008,36,14,2007/2008,50,1,13,12,-Inf
2007/2008,36,15,2007/2008,51,3,4,1,-11.512925464970229
2007/2008,36,16,2007/2008,52,5,1,4,-Inf
2007/2008,36,17,2008/2009,1,2,10,8,-Inf
2007/2008,36,18,2008/2009,2,3,8,5,-Inf
2007/2008,36,19,2008/2009,3,2,13,11,-Inf
2007/2008,36,20,2008/2009,4,3,10,7,-11.512925464970229
2007/2008,36,21,2008/2009,5,2,21,19,-Inf
2007/2008,36,22,2008/2009,6,2,18,16,-Inf
2007/2008,36,23,2008/2009,7,3,21,18,-Inf
2007/2008,36,24,2008/2009,8,4,34,30,-Inf
2007/2008,36,25,2008/2009,9,3,25,22,-Inf
2007/2008,36,26,2008/2009,10,4,34,30,-Inf
2007/2008,36,27,2008/2009,11,4,33,29,-Inf
2007/2008,36,28,2008/2009,12,4,40,36,-Inf
2007/2008,36,29,2008/2009,13,7,42,35,-Inf
2007/2008,36,30,2008/2009,14,6,36,30,-Inf
2007/2008,36,31,2008/2009,15,15,72,57,-Inf
2007/2008,36,32,2008/2009,16,11,75,64,-Inf
2007/2008,36,33,2008/2009,17,9,76,67,-Inf
2007/2008,36,34,2008/2009,18,9,92,83,-Inf
2007/2008,36,35,2008/2009,19,12,71,59,-Inf
2007/2008,36,36,2008/2009,20,13,112,99,-Inf
2007/2008,36,37,2008/2009,21,13,106,93,-Inf
2007/2008,36,38,2008/2009,22,13,101,88,-Inf
2007/2008,36,39,2008/2009,23,20,170,150,-Inf
2007/2008,36,40,2008/2009,24,28,135,107,-Inf
2007/2008,36,41,2008/2009,25,45,106,61,-Inf
2007/2008,36,42,2008/2009,26,28,68,40,-Inf
2007/2008,36,43,2008/2009,27,34,48,14,-Inf
2007/2008,36,44,2008/2009,28,41,48,7,-Inf
2007/2008,36,45,2008/2009,29,36,26,10,-Inf
2007/2008,36,46,2008/2009,30,38,33,5,-Inf
2007/2008,36,47,2008/2009,31,48,29,19,-Inf
2007/2008,36,48,2008/2009,32,27,17,10,-Inf
2007/2008,36,49,2008/2009,33,23,12,11,-Inf
2007/2008,36,50,2008/2009,34,28,13,15,-Inf
2007/2008,36,51,2008/2009,35,42,17,25,-Inf
2007/2008,36,52,2008/2009,36,30,15,15,-Inf
2007/2008,37,1,2007/2008,38,15,21,6,-Inf
2007/2008,37,2,2007/2008,39,10,11,1,-Inf
2007/2008,37,3,2007/2008,40,9,9,0,-0.4395597818789927
2007/2008,37,4,2007/2008,41,2,14,12,-Inf
2007/2008,37,5,2007/2008,42,6,14,8,-Inf
2007/2008,37,6,2007/2008,43,8,15,7,-Inf
2007/2008,37,7,2007/2008,44,5,18,13,-Inf
2007/2008,37,8,2007/2008,45,1,16,15,-Inf
2007/2008,37,9,2007/2008,46,2,12,10,-Inf
2007/2008,37,10,2007/2008,47,3,20,17,-Inf
2007/2008,37,11,2007/2008,48,4,8,4,-Inf
2007/2008,37,12,2007/2008,49,3,3,0,-0.36450552305392137
2007/2008,37,13,2007/2008,50,1,13,12,-11.512925464970229
2007/2008,37,14,2007/2008,51,3,4,1,-10.819778284410283
2007/2008,37,15,2007/2008,52,5,1,4,-11.512925464970229
2007/2008,37,16,2008/2009,1,2,10,8,-Inf
2007/2008,37,17,2008/2009,2,3,8,5,-Inf
2007/2008,37,18,2008/2009,3,2,13,11,-Inf
2007/2008,37,19,2008/2009,4,3,10,7,-Inf
2007/2008,37,20,2008/2009,5,2,21,19,-Inf
2007/2008,37,21,2008/2009,6,2,18,16,-Inf
2007/2008,37,22,2008/2009,7,3,21,18,-Inf
2007/2008,37,23,2008/2009,8,4,34,30,-Inf
2007/2008,37,24,2008/2009,9,3,25,22,-Inf
2007/2008,37,25,2008/2009,10,4,34,30,-Inf
2007/2008,37,26,2008/2009,11,4,33,29,-Inf
2007/2008,37,27,2008/2009,12,4,40,36,-Inf
2007/2008,37,28,2008/2009,13,7,42,35,-Inf
2007/2008,37,29,2008/2009,14,6,36,30,-Inf
2007/2008,37,30,2008/2009,15,15,72,57,-Inf
2007/2008,37,31,2008/2009,16,11,75,64,-Inf
2007/2008,37,32,2008/2009,17,9,76,67,-Inf
2007/2008,37,33,2008/2009,18,9,92,83,-Inf
2007/2008,37,34,2008/2009,19,12,71,59,-Inf
2007/2008,37,35,2008/2009,20,13,112,99,-Inf
2007/2008,37,36,2008/2009,21,13,106,93,-Inf
2007/2008,37,37,2008/2009,22,13,101,88,-Inf
2007/2008,37,38,2008/2009,23,20,170,150,-Inf
2007/2008,37,39,2008/2009,24,28,135,107,-Inf
2007/2008,37,40,2008/2009,25,45,106,61,-Inf
2007/2008,37,41,2008/2009,26,28,68,40,-Inf
2007/2008,37,42,2008/2009,27,34,48,14,-Inf
2007/2008,37,43,2008/2009,28,41,48,7,-Inf
2007/2008,37,44,2008/2009,29,36,26,10,-Inf
2007/2008,37,45,2008/2009,30,38,33,5,-Inf
2007/2008,37,46,2008/2009,31,48,29,19,-Inf
2007/2008,37,47,2008/2009,32,27,17,10,-11.512925464970229
2007/2008,37,48,2008/2009,33,23,12,11,-Inf
2007/2008,37,49,2008/2009,34,28,13,15,-Inf
2007/2008,37,50,2008/2009,35,42,17,25,-Inf
2007/2008,37,51,2008/2009,36,30,15,15,-Inf
2007/2008,37,52,2008/2009,37,18,14,4,-Inf
2007/2008,38,1,2007/2008,39,10,11,1,-Inf
2007/2008,38,2,2007/2008,40,9,9,0,-0.170408796330344
2007/2008,38,3,2007/2008,41,2,14,12,-Inf
2007/2008,38,4,2007/2008,42,6,14,8,-Inf
2007/2008,38,5,2007/2008,43,8,15,7,-Inf
2007/2008,38,6,2007/2008,44,5,18,13,-Inf
2007/2008,38,7,2007/2008,45,1,16,15,-Inf
2007/2008,38,8,2007/2008,46,2,12,10,-11.512925464970229
2007/2008,38,9,2007/2008,47,3,20,17,-Inf
2007/2008,38,10,2007/2008,48,4,8,4,-Inf
2007/2008,38,11,2007/2008,49,3,3,0,-0.22687550640388743
2007/2008,38,12,2007/2008,50,1,13,12,-Inf
2007/2008,38,13,2007/2008,51,3,4,1,-Inf
2007/2008,38,14,2007/2008,52,5,1,4,-Inf
2007/2008,38,15,2008/2009,1,2,10,8,-Inf
2007/2008,38,16,2008/2009,2,3,8,5,-11.512925464970229
2007/2008,38,17,2008/2009,3,2,13,11,-Inf
2007/2008,38,18,2008/2009,4,3,10,7,-Inf
2007/2008,38,19,2008/2009,5,2,21,19,-Inf
2007/2008,38,20,2008/2009,6,2,18,16,-Inf
2007/2008,38,21,2008/2009,7,3,21,18,-Inf
2007/2008,38,22,2008/2009,8,4,34,30,-11.512925464970229
2007/2008,38,23,2008/2009,9,3,25,22,-Inf
2007/2008,38,24,2008/2009,10,4,34,30,-Inf
2007/2008,38,25,2008/2009,11,4,33,29,-11.512925464970229
2007/2008,38,26,2008/2009,12,4,40,36,-Inf
2007/2008,38,27,2008/2009,13,7,42,35,-Inf
2007/2008,38,28,2008/2009,14,6,36,30,-Inf
2007/2008,38,29,2008/2009,15,15,72,57,-Inf
2007/2008,38,30,2008/2009,16,11,75,64,-Inf
2007/2008,38,31,2008/2009,17,9,76,67,-Inf
2007/2008,38,32,2008/2009,18,9,92,83,-Inf
2007/2008,38,33,2008/2009,19,12,71,59,-Inf
2007/2008,38,34,2008/2009,20,13,112,99,-Inf
2007/2008,38,35,2008/2009,21,13,106,93,-Inf
2007/2008,38,36,2008/2009,22,13,101,88,-Inf
2007/2008,38,37,2008/2009,23,20,170,150,-Inf
2007/2008,38,38,2008/2009,24,28,135,107,-Inf
2007/2008,38,39,2008/2009,25,45,106,61,-Inf
2007/2008,38,40,2008/2009,26,28,68,40,-Inf
2007/2008,38,41,2008/2009,27,34,48,14,-Inf
2007/2008,38,42,2008/2009,28,41,48,7,-Inf
2007/2008,38,43,2008/2009,29,36,26,10,-Inf
2007/2008,38,44,2008/2009,30,38,33,5,-Inf
2007/2008,38,45,2008/2009,31,48,29,19,-Inf
2007/2008,38,46,2008/2009,32,27,17,10,-Inf
2007/2008,38,47,2008/2009,33,23,12,11,-Inf
2007/2008,38,48,2008/2009,34,28,13,15,-Inf
2007/2008,38,49,2008/2009,35,42,17,25,-Inf
2007/2008,38,50,2008/2009,36,30,15,15,-Inf
2007/2008,38,51,2008/2009,37,18,14,4,-Inf
2007/2008,38,52,2008/2009,38,38,15,23,-Inf
2007/2008,39,1,2007/2008,40,9,9,0,-0.08005020770166205
2007/2008,39,2,2007/2008,41,2,14,12,-Inf
2007/2008,39,3,2007/2008,42,6,14,8,-Inf
2007/2008,39,4,2007/2008,43,8,15,7,-Inf
2007/2008,39,5,2007/2008,44,5,18,13,-Inf
2007/2008,39,6,2007/2008,45,1,16,15,-Inf
2007/2008,39,7,2007/2008,46,2,12,10,-Inf
2007/2008,39,8,2007/2008,47,3,20,17,-Inf
2007/2008,39,9,2007/2008,48,4,8,4,-Inf
2007/2008,39,10,2007/2008,49,3,3,0,-0.22280610825452385
2007/2008,39,11,2007/2008,50,1,13,12,-Inf
2007/2008,39,12,2007/2008,51,3,4,1,-11.512925464970229
2007/2008,39,13,2007/2008,52,5,1,4,-Inf
2007/2008,39,14,2008/2009,1,2,10,8,-11.512925464970229
2007/2008,39,15,2008/2009,2,3,8,5,-Inf
2007/2008,39,16,2008/2009,3,2,13,11,-Inf
2007/2008,39,17,2008/2009,4,3,10,7,-11.512925464970229
2007/2008,39,18,2008/2009,5,2,21,19,-Inf
2007/2008,39,19,2008/2009,6,2,18,16,-Inf
2007/2008,39,20,2008/2009,7,3,21,18,-Inf
2007/2008,39,21,2008/2009,8,4,34,30,-Inf
2007/2008,39,22,2008/2009,9,3,25,22,-Inf
2007/2008,39,23,2008/2009,10,4,34,30,-Inf
2007/2008,39,24,2008/2009,11,4,33,29,-Inf
2007/2008,39,25,2008/2009,12,4,40,36,-Inf
2007/2008,39,26,2008/2009,13,7,42,35,-Inf
2007/2008,39,27,2008/2009,14,6,36,30,-Inf
2007/2008,39,28,2008/2009,15,15,72,57,-Inf
2007/2008,39,29,2008/2009,16,11,75,64,-Inf
2007/2008,39,30,2008/2009,17,9,76,67,-Inf
2007/2008,39,31,2008/2009,18,9,92,83,-Inf
2007/2008,39,32,2008/2009,19,12,71,59,-Inf
2007/2008,39,33,2008/2009,20,13,112,99,-Inf
2007/2008,39,34,2008/2009,21,13,106,93,-Inf
2007/2008,39,35,2008/2009,22,13,101,88,-Inf
2007/2008,39,36,2008/2009,23,20,170,150,-Inf
2007/2008,39,37,2008/2009,24,28,135,107,-11.512925464970229
2007/2008,39,38,2008/2009,25,45,106,61,-Inf
2007/2008,39,39,2008/2009,26,28,68,40,-Inf
2007/2008,39,40,2008/2009,27,34,48,14,-Inf
2007/2008,39,41,2008/2009,28,41,48,7,-Inf
2007/2008,39,42,2008/2009,29,36,26,10,-Inf
2007/2008,39,43,2008/2009,30,38,33,5,-Inf
2007/2008,39,44,2008/2009,31,48,29,19,-Inf
2007/2008,39,45,2008/2009,32,27,17,10,-Inf
2007/2008,39,46,2008/2009,33,23,12,11,-11.512925464970229
2007/2008,39,47,2008/2009,34,28,13,15,-Inf
2007/2008,39,48,2008/2009,35,42,17,25,-Inf
2007/2008,39,49,2008/2009,36,30,15,15,-Inf
2007/2008,39,50,2008/2009,37,18,14,4,-Inf
2007/2008,39,51,2008/2009,38,38,15,23,-Inf
2007/2008,39,52,2008/2009,39,28,10,18,-Inf
2007/2008,3,1,2007/2008,4,10,5,5,-11.512925464970229
2007/2008,3,2,2007/2008,5,21,11,10,-Inf
2007/2008,3,3,2007/2008,6,18,5,13,-Inf
2007/2008,3,4,2007/2008,7,21,5,16,-Inf
2007/2008,3,5,2007/2008,8,34,6,28,-Inf
2007/2008,3,6,2007/2008,9,25,6,19,-Inf
2007/2008,3,7,2007/2008,10,34,4,30,-Inf
2007/2008,3,8,2007/2008,11,33,4,29,-Inf
2007/2008,3,9,2007/2008,12,40,8,32,-Inf
2007/2008,3,10,2007/2008,13,42,14,28,-Inf
2007/2008,3,11,2007/2008,14,36,12,24,-Inf
2007/2008,3,12,2007/2008,15,72,16,56,-Inf
2007/2008,3,13,2007/2008,16,75,10,65,-Inf
2007/2008,3,14,2007/2008,17,76,16,60,-Inf
2007/2008,3,15,2007/2008,18,92,18,74,-Inf
2007/2008,3,16,2007/2008,19,71,15,56,-Inf
2007/2008,3,17,2007/2008,20,112,23,89,-Inf
2007/2008,3,18,2007/2008,21,106,17,89,-Inf
2007/2008,3,19,2007/2008,22,101,33,68,-Inf
2007/2008,3,20,2007/2008,23,170,15,155,-Inf
2007/2008,3,21,2007/2008,24,135,13,122,-Inf
2007/2008,3,22,2007/2008,25,106,11,95,-Inf
2007/2008,3,23,2007/2008,26,68,14,54,-Inf
2007/2008,3,24,2007/2008,27,48,17,31,-Inf
2007/2008,3,25,2007/2008,28,48,19,29,-Inf
2007/2008,3,26,2007/2008,29,26,20,6,-Inf
2007/2008,3,27,2007/2008,30,33,12,21,-Inf
2007/2008,3,28,2007/2008,31,29,21,8,-Inf
2007/2008,3,29,2007/2008,32,17,7,10,-Inf
2007/2008,3,30,2007/2008,33,12,19,7,-Inf
2007/2008,3,31,2007/2008,34,13,10,3,-Inf
2007/2008,3,32,2007/2008,35,17,13,4,-Inf
2007/2008,3,33,2007/2008,36,15,10,5,-Inf
2007/2008,3,34,2007/2008,37,14,8,6,-Inf
2007/2008,3,35,2007/2008,38,15,21,6,-Inf
2007/2008,3,36,2007/2008,39,10,11,1,-11.512925464970229
2007/2008,3,37,2007/2008,40,9,9,0,-0.3439984879306852
2007/2008,3,38,2007/2008,41,2,14,12,-Inf
2007/2008,3,39,2007/2008,42,6,14,8,-Inf
2007/2008,3,40,2007/2008,43,8,15,7,-Inf
2007/2008,3,41,2007/2008,44,5,18,13,-Inf
2007/2008,3,42,2007/2008,45,1,16,15,-Inf
2007/2008,3,43,2007/2008,46,2,12,10,-Inf
2007/2008,3,44,2007/2008,47,3,20,17,-Inf
2007/2008,3,45,2007/2008,48,4,8,4,-Inf
2007/2008,3,46,2007/2008,49,3,3,0,-0.3490327911460973
2007/2008,3,47,2007/2008,50,1,13,12,-Inf
2007/2008,3,48,2007/2008,51,3,4,1,-10.819778284410283
2007/2008,3,49,2007/2008,52,5,1,4,-Inf
2007/2008,3,50,2008/2009,1,2,10,8,-Inf
2007/2008,3,51,2008/2009,2,3,8,5,-Inf
2007/2008,3,52,2008/2009,3,2,13,11,-Inf
2007/2008,40,1,2007/2008,41,2,14,12,-Inf
2007/2008,40,2,2007/2008,42,6,14,8,-Inf
2007/2008,40,3,2007/2008,43,8,15,7,-Inf
2007/2008,40,4,2007/2008,44,5,18,13,-Inf
2007/2008,40,5,2007/2008,45,1,16,15,-11.512925464970229
2007/2008,40,6,2007/2008,46,2,12,10,-Inf
2007/2008,40,7,2007/2008,47,3,20,17,-Inf
2007/2008,40,8,2007/2008,48,4,8,4,-11.512925464970229
2007/2008,40,9,2007/2008,49,3,3,0,-0.21112852173600594
2007/2008,40,10,2007/2008,50,1,13,12,-Inf
2007/2008,40,11,2007/2008,51,3,4,1,-11.512925464970229
2007/2008,40,12,2007/2008,52,5,1,4,-Inf
2007/2008,40,13,2008/2009,1,2,10,8,-Inf
2007/2008,40,14,2008/2009,2,3,8,5,-Inf
2007/2008,40,15,2008/2009,3,2,13,11,-Inf
2007/2008,40,16,2008/2009,4,3,10,7,-11.512925464970229
2007/2008,40,17,2008/2009,5,2,21,19,-Inf
2007/2008,40,18,2008/2009,6,2,18,16,-11.512925464970229
2007/2008,40,19,2008/2009,7,3,21,18,-Inf
2007/2008,40,20,2008/2009,8,4,34,30,-Inf
2007/2008,40,21,2008/2009,9,3,25,22,-Inf
2007/2008,40,22,2008/2009,10,4,34,30,-Inf
2007/2008,40,23,2008/2009,11,4,33,29,-Inf
2007/2008,40,24,2008/2009,12,4,40,36,-Inf
2007/2008,40,25,2008/2009,13,7,42,35,-Inf
2007/2008,40,26,2008/2009,14,6,36,30,-Inf
2007/2008,40,27,2008/2009,15,15,72,57,-Inf
2007/2008,40,28,2008/2009,16,11,75,64,-Inf
2007/2008,40,29,2008/2009,17,9,76,67,-Inf
2007/2008,40,30,2008/2009,18,9,92,83,-Inf
2007/2008,40,31,2008/2009,19,12,71,59,-Inf
2007/2008,40,32,2008/2009,20,13,112,99,-Inf
2007/2008,40,33,2008/2009,21,13,106,93,-Inf
2007/2008,40,34,2008/2009,22,13,101,88,-Inf
2007/2008,40,35,2008/2009,23,20,170,150,-Inf
2007/2008,40,36,2008/2009,24,28,135,107,-Inf
2007/2008,40,37,2008/2009,25,45,106,61,-Inf
2007/2008,40,38,2008/2009,26,28,68,40,-Inf
2007/2008,40,39,2008/2009,27,34,48,14,-Inf
2007/2008,40,40,2008/2009,28,41,48,7,-11.512925464970229
2007/2008,40,41,2008/2009,29,36,26,10,-Inf
2007/2008,40,42,2008/2009,30,38,33,5,-Inf
2007/2008,40,43,2008/2009,31,48,29,19,-Inf
2007/2008,40,44,2008/2009,32,27,17,10,-Inf
2007/2008,40,45,2008/2009,33,23,12,11,-11.512925464970229
2007/2008,40,46,2008/2009,34,28,13,15,-Inf
2007/2008,40,47,2008/2009,35,42,17,25,-Inf
2007/2008,40,48,2008/2009,36,30,15,15,-Inf
2007/2008,40,49,2008/2009,37,18,14,4,-Inf
2007/2008,40,50,2008/2009,38,38,15,23,-Inf
2007/2008,40,51,2008/2009,39,28,10,18,-Inf
2007/2008,40,52,2008/2009,40,36,9,27,-Inf
2007/2008,41,1,2007/2008,42,6,14,8,-Inf
2007/2008,41,2,2007/2008,43,8,15,7,-Inf
2007/2008,41,3,2007/2008,44,5,18,13,-Inf
2007/2008,41,4,2007/2008,45,1,16,15,-Inf
2007/2008,41,5,2007/2008,46,2,12,10,-Inf
2007/2008,41,6,2007/2008,47,3,20,17,-Inf
2007/2008,41,7,2007/2008,48,4,8,4,-11.512925464970229
2007/2008,41,8,2007/2008,49,3,3,0,-0.2862697369339493
2007/2008,41,9,2007/2008,50,1,13,12,-Inf
2007/2008,41,10,2007/2008,51,3,4,1,-10.126631103850338
2007/2008,41,11,2007/2008,52,5,1,4,-Inf
2007/2008,41,12,2008/2009,1,2,10,8,-Inf
2007/2008,41,13,2008/2009,2,3,8,5,-Inf
2007/2008,41,14,2008/2009,3,2,13,11,-Inf
2007/2008,41,15,2008/2009,4,3,10,7,-10.819778284410283
2007/2008,41,16,2008/2009,5,2,21,19,-Inf
2007/2008,41,17,2008/2009,6,2,18,16,-11.512925464970229
2007/2008,41,18,2008/2009,7,3,21,18,-Inf
2007/2008,41,19,2008/2009,8,4,34,30,-Inf
2007/2008,41,20,2008/2009,9,3,25,22,-Inf
2007/2008,41,21,2008/2009,10,4,34,30,-Inf
2007/2008,41,22,2008/2009,11,4,33,29,-Inf
2007/2008,41,23,2008/2009,12,4,40,36,-Inf
2007/2008,41,24,2008/2009,13,7,42,35,-Inf
2007/2008,41,25,2008/2009,14,6,36,30,-Inf
2007/2008,41,26,2008/2009,15,15,72,57,-Inf
2007/2008,41,27,2008/2009,16,11,75,64,-Inf
2007/2008,41,28,2008/2009,17,9,76,67,-Inf
2007/2008,41,29,2008/2009,18,9,92,83,-Inf
2007/2008,41,30,2008/2009,19,12,71,59,-Inf
2007/2008,41,31,2008/2009,20,13,112,99,-Inf
2007/2008,41,32,2008/2009,21,13,106,93,-Inf
2007/2008,41,33,2008/2009,22,13,101,88,-Inf
2007/2008,41,34,2008/2009,23,20,170,150,-Inf
2007/2008,41,35,2008/2009,24,28,135,107,-Inf
2007/2008,41,36,2008/2009,25,45,106,61,-Inf
2007/2008,41,37,2008/2009,26,28,68,40,-Inf
2007/2008,41,38,2008/2009,27,34,48,14,-Inf
2007/2008,41,39,2008/2009,28,41,48,7,-Inf
2007/2008,41,40,2008/2009,29,36,26,10,-Inf
2007/2008,41,41,2008/2009,30,38,33,5,-Inf
2007/2008,41,42,2008/2009,31,48,29,19,-Inf
2007/2008,41,43,2008/2009,32,27,17,10,-Inf
2007/2008,41,44,2008/2009,33,23,12,11,-Inf
2007/2008,41,45,2008/2009,34,28,13,15,-Inf
2007/2008,41,46,2008/2009,35,42,17,25,-Inf
2007/2008,41,47,2008/2009,36,30,15,15,-Inf
2007/2008,41,48,2008/2009,37,18,14,4,-11.512925464970229
2007/2008,41,49,2008/2009,38,38,15,23,-Inf
2007/2008,41,50,2008/2009,39,28,10,18,-Inf
2007/2008,41,51,2008/2009,40,36,9,27,-Inf
2007/2008,41,52,2008/2009,41,44,2,42,-Inf
2007/2008,42,1,2007/2008,43,8,15,7,-Inf
2007/2008,42,2,2007/2008,44,5,18,13,-Inf
2007/2008,42,3,2007/2008,45,1,16,15,-Inf
2007/2008,42,4,2007/2008,46,2,12,10,-11.512925464970229
2007/2008,42,5,2007/2008,47,3,20,17,-Inf
2007/2008,42,6,2007/2008,48,4,8,4,-Inf
2007/2008,42,7,2007/2008,49,3,3,0,-0.3649951755544514
2007/2008,42,8,2007/2008,50,1,13,12,-Inf
2007/2008,42,9,2007/2008,51,3,4,1,-10.41431317630212
2007/2008,42,10,2007/2008,52,5,1,4,-Inf
2007/2008,42,11,2008/2009,1,2,10,8,-Inf
2007/2008,42,12,2008/2009,2,3,8,5,-Inf
2007/2008,42,13,2008/2009,3,2,13,11,-Inf
2007/2008,42,14,2008/2009,4,3,10,7,-Inf
2007/2008,42,15,2008/2009,5,2,21,19,-11.512925464970229
2007/2008,42,16,2008/2009,6,2,18,16,-Inf
2007/2008,42,17,2008/2009,7,3,21,18,-Inf
2007/2008,42,18,2008/2009,8,4,34,30,-Inf
2007/2008,42,19,2008/2009,9,3,25,22,-Inf
2007/2008,42,20,2008/2009,10,4,34,30,-Inf
2007/2008,42,21,2008/2009,11,4,33,29,-Inf
2007/2008,42,22,2008/2009,12,4,40,36,-Inf
2007/2008,42,23,2008/2009,13,7,42,35,-Inf
2007/2008,42,24,2008/2009,14,6,36,30,-Inf
2007/2008,42,25,2008/2009,15,15,72,57,-Inf
2007/2008,42,26,2008/2009,16,11,75,64,-Inf
2007/2008,42,27,2008/2009,17,9,76,67,-Inf
2007/2008,42,28,2008/2009,18,9,92,83,-Inf
2007/2008,42,29,2008/2009,19,12,71,59,-Inf
2007/2008,42,30,2008/2009,20,13,112,99,-Inf
2007/2008,42,31,2008/2009,21,13,106,93,-Inf
2007/2008,42,32,2008/2009,22,13,101,88,-Inf
2007/2008,42,33,2008/2009,23,20,170,150,-Inf
2007/2008,42,34,2008/2009,24,28,135,107,-Inf
2007/2008,42,35,2008/2009,25,45,106,61,-Inf
2007/2008,42,36,2008/2009,26,28,68,40,-Inf
2007/2008,42,37,2008/2009,27,34,48,14,-Inf
2007/2008,42,38,2008/2009,28,41,48,7,-11.512925464970229
2007/2008,42,39,2008/2009,29,36,26,10,-Inf
2007/2008,42,40,2008/2009,30,38,33,5,-Inf
2007/2008,42,41,2008/2009,31,48,29,19,-Inf
2007/2008,42,42,2008/2009,32,27,17,10,-Inf
2007/2008,42,43,2008/2009,33,23,12,11,-Inf
2007/2008,42,44,2008/2009,34,28,13,15,-Inf
2007/2008,42,45,2008/2009,35,42,17,25,-Inf
2007/2008,42,46,2008/2009,36,30,15,15,-Inf
2007/2008,42,47,2008/2009,37,18,14,4,-Inf
2007/2008,42,48,2008/2009,38,38,15,23,-Inf
2007/2008,42,49,2008/2009,39,28,10,18,-Inf
2007/2008,42,50,2008/2009,40,36,9,27,-Inf
2007/2008,42,51,2008/2009,41,44,2,42,-11.512925464970229
2007/2008,42,52,2008/2009,42,41,6,35,-Inf
2007/2008,43,1,2007/2008,44,5,18,13,-Inf
2007/2008,43,2,2007/2008,45,1,16,15,-Inf
2007/2008,43,3,2007/2008,46,2,12,10,-Inf
2007/2008,43,4,2007/2008,47,3,20,17,-11.512925464970229
2007/2008,43,5,2007/2008,48,4,8,4,-11.512925464970229
2007/2008,43,6,2007/2008,49,3,3,0,-0.4026440909214628
2007/2008,43,7,2007/2008,50,1,13,12,-Inf
2007/2008,43,8,2007/2008,51,3,4,1,-Inf
2007/2008,43,9,2007/2008,52,5,1,4,-Inf
2007/2008,43,10,2008/2009,1,2,10,8,-Inf
2007/2008,43,11,2008/2009,2,3,8,5,-Inf
2007/2008,43,12,2008/2009,3,2,13,11,-Inf
2007/2008,43,13,2008/2009,4,3,10,7,-Inf
2007/2008,43,14,2008/2009,5,2,21,19,-Inf
2007/2008,43,15,2008/2009,6,2,18,16,-Inf
2007/2008,43,16,2008/2009,7,3,21,18,-Inf
2007/2008,43,17,2008/2009,8,4,34,30,-Inf
2007/2008,43,18,2008/2009,9,3,25,22,-Inf
2007/2008,43,19,2008/2009,10,4,34,30,-Inf
2007/2008,43,20,2008/2009,11,4,33,29,-Inf
2007/2008,43,21,2008/2009,12,4,40,36,-Inf
2007/2008,43,22,2008/2009,13,7,42,35,-Inf
2007/2008,43,23,2008/2009,14,6,36,30,-Inf
2007/2008,43,24,2008/2009,15,15,72,57,-Inf
2007/2008,43,25,2008/2009,16,11,75,64,-Inf
2007/2008,43,26,2008/2009,17,9,76,67,-Inf
2007/2008,43,27,2008/2009,18,9,92,83,-Inf
2007/2008,43,28,2008/2009,19,12,71,59,-Inf
2007/2008,43,29,2008/2009,20,13,112,99,-Inf
2007/2008,43,30,2008/2009,21,13,106,93,-Inf
2007/2008,43,31,2008/2009,22,13,101,88,-Inf
2007/2008,43,32,2008/2009,23,20,170,150,-Inf
2007/2008,43,33,2008/2009,24,28,135,107,-Inf
2007/2008,43,34,2008/2009,25,45,106,61,-11.512925464970229
2007/2008,43,35,2008/2009,26,28,68,40,-Inf
2007/2008,43,36,2008/2009,27,34,48,14,-Inf
2007/2008,43,37,2008/2009,28,41,48,7,-Inf
2007/2008,43,38,2008/2009,29,36,26,10,-11.512925464970229
2007/2008,43,39,2008/2009,30,38,33,5,-Inf
2007/2008,43,40,2008/2009,31,48,29,19,-Inf
2007/2008,43,41,2008/2009,32,27,17,10,-Inf
2007/2008,43,42,2008/2009,33,23,12,11,-Inf
2007/2008,43,43,2008/2009,34,28,13,15,-Inf
2007/2008,43,44,2008/2009,35,42,17,25,-11.512925464970229
2007/2008,43,45,2008/2009,36,30,15,15,-Inf
2007/2008,43,46,2008/2009,37,18,14,4,-Inf
2007/2008,43,47,2008/2009,38,38,15,23,-Inf
2007/2008,43,48,2008/2009,39,28,10,18,-Inf
2007/2008,43,49,2008/2009,40,36,9,27,-Inf
2007/2008,43,50,2008/2009,41,44,2,42,-Inf
2007/2008,43,51,2008/2009,42,41,6,35,-Inf
2007/2008,43,52,2008/2009,43,35,8,27,-Inf
2007/2008,44,1,2007/2008,45,1,16,15,-10.819778284410283
2007/2008,44,2,2007/2008,46,2,12,10,-Inf
2007/2008,44,3,2007/2008,47,3,20,17,-11.512925464970229
2007/2008,44,4,2007/2008,48,4,8,4,-11.512925464970229
2007/2008,44,5,2007/2008,49,3,3,0,-0.44609962020434857
2007/2008,44,6,2007/2008,50,1,13,12,-Inf
2007/2008,44,7,2007/2008,51,3,4,1,-11.512925464970229
2007/2008,44,8,2007/2008,52,5,1,4,-Inf
2007/2008,44,9,2008/2009,1,2,10,8,-11.512925464970229
2007/2008,44,10,2008/2009,2,3,8,5,-11.512925464970229
2007/2008,44,11,2008/2009,3,2,13,11,-11.512925464970229
2007/2008,44,12,2008/2009,4,3,10,7,-Inf
2007/2008,44,13,2008/2009,5,2,21,19,-Inf
2007/2008,44,14,2008/2009,6,2,18,16,-Inf
2007/2008,44,15,2008/2009,7,3,21,18,-Inf
2007/2008,44,16,2008/2009,8,4,34,30,-Inf
2007/2008,44,17,2008/2009,9,3,25,22,-Inf
2007/2008,44,18,2008/2009,10,4,34,30,-Inf
2007/2008,44,19,2008/2009,11,4,33,29,-Inf
2007/2008,44,20,2008/2009,12,4,40,36,-Inf
2007/2008,44,21,2008/2009,13,7,42,35,-Inf
2007/2008,44,22,2008/2009,14,6,36,30,-Inf
2007/2008,44,23,2008/2009,15,15,72,57,-Inf
2007/2008,44,24,2008/2009,16,11,75,64,-Inf
2007/2008,44,25,2008/2009,17,9,76,67,-Inf
2007/2008,44,26,2008/2009,18,9,92,83,-Inf
2007/2008,44,27,2008/2009,19,12,71,59,-Inf
2007/2008,44,28,2008/2009,20,13,112,99,-Inf
2007/2008,44,29,2008/2009,21,13,106,93,-Inf
2007/2008,44,30,2008/2009,22,13,101,88,-Inf
2007/2008,44,31,2008/2009,23,20,170,150,-Inf
2007/2008,44,32,2008/2009,24,28,135,107,-Inf
2007/2008,44,33,2008/2009,25,45,106,61,-Inf
2007/2008,44,34,2008/2009,26,28,68,40,-Inf
2007/2008,44,35,2008/2009,27,34,48,14,-Inf
2007/2008,44,36,2008/2009,28,41,48,7,-Inf
2007/2008,44,37,2008/2009,29,36,26,10,-Inf
2007/2008,44,38,2008/2009,30,38,33,5,-Inf
2007/2008,44,39,2008/2009,31,48,29,19,-Inf
2007/2008,44,40,2008/2009,32,27,17,10,-Inf
2007/2008,44,41,2008/2009,33,23,12,11,-Inf
2007/2008,44,42,2008/2009,34,28,13,15,-Inf
2007/2008,44,43,2008/2009,35,42,17,25,-Inf
2007/2008,44,44,2008/2009,36,30,15,15,-Inf
2007/2008,44,45,2008/2009,37,18,14,4,-Inf
2007/2008,44,46,2008/2009,38,38,15,23,-Inf
2007/2008,44,47,2008/2009,39,28,10,18,-Inf
2007/2008,44,48,2008/2009,40,36,9,27,-Inf
2007/2008,44,49,2008/2009,41,44,2,42,-Inf
2007/2008,44,50,2008/2009,42,41,6,35,-Inf
2007/2008,44,51,2008/2009,43,35,8,27,-Inf
2007/2008,44,52,2008/2009,44,28,5,23,-Inf
2007/2008,45,1,2007/2008,46,2,12,10,-11.512925464970229
2007/2008,45,2,2007/2008,47,3,20,17,-Inf
2007/2008,45,3,2007/2008,48,4,8,4,-11.512925464970229
2007/2008,45,4,2007/2008,49,3,3,0,-0.5128443266429112
2007/2008,45,5,2007/2008,50,1,13,12,-Inf
2007/2008,45,6,2007/2008,51,3,4,1,-10.41431317630212
2007/2008,45,7,2007/2008,52,5,1,4,-Inf
2007/2008,45,8,2008/2009,1,2,10,8,-Inf
2007/2008,45,9,2008/2009,2,3,8,5,-11.512925464970229
2007/2008,45,10,2008/2009,3,2,13,11,-Inf
2007/2008,45,11,2008/2009,4,3,10,7,-Inf
2007/2008,45,12,2008/2009,5,2,21,19,-Inf
2007/2008,45,13,2008/2009,6,2,18,16,-Inf
2007/2008,45,14,2008/2009,7,3,21,18,-Inf
2007/2008,45,15,2008/2009,8,4,34,30,-Inf
2007/2008,45,16,2008/2009,9,3,25,22,-Inf
2007/2008,45,17,2008/2009,10,4,34,30,-Inf
2007/2008,45,18,2008/2009,11,4,33,29,-Inf
2007/2008,45,19,2008/2009,12,4,40,36,-11.512925464970229
2007/2008,45,20,2008/2009,13,7,42,35,-Inf
2007/2008,45,21,2008/2009,14,6,36,30,-Inf
2007/2008,45,22,2008/2009,15,15,72,57,-Inf
2007/2008,45,23,2008/2009,16,11,75,64,-Inf
2007/2008,45,24,2008/2009,17,9,76,67,-Inf
2007/2008,45,25,2008/2009,18,9,92,83,-Inf
2007/2008,45,26,2008/2009,19,12,71,59,-Inf
2007/2008,45,27,2008/2009,20,13,112,99,-Inf
2007/2008,45,28,2008/2009,21,13,106,93,-Inf
2007/2008,45,29,2008/2009,22,13,101,88,-Inf
2007/2008,45,30,2008/2009,23,20,170,150,-Inf
2007/2008,45,31,2008/2009,24,28,135,107,-Inf
2007/2008,45,32,2008/2009,25,45,106,61,-Inf
2007/2008,45,33,2008/2009,26,28,68,40,-Inf
2007/2008,45,34,2008/2009,27,34,48,14,-Inf
2007/2008,45,35,2008/2009,28,41,48,7,-Inf
2007/2008,45,36,2008/2009,29,36,26,10,-Inf
2007/2008,45,37,2008/2009,30,38,33,5,-11.512925464970229
2007/2008,45,38,2008/2009,31,48,29,19,-Inf
2007/2008,45,39,2008/2009,32,27,17,10,-11.512925464970229
2007/2008,45,40,2008/2009,33,23,12,11,-Inf
2007/2008,45,41,2008/2009,34,28,13,15,-Inf
2007/2008,45,42,2008/2009,35,42,17,25,-Inf
2007/2008,45,43,2008/2009,36,30,15,15,-Inf
2007/2008,45,44,2008/2009,37,18,14,4,-Inf
2007/2008,45,45,2008/2009,38,38,15,23,-Inf
2007/2008,45,46,2008/2009,39,28,10,18,-Inf
2007/2008,45,47,2008/2009,40,36,9,27,-Inf
2007/2008,45,48,2008/2009,41,44,2,42,-Inf
2007/2008,45,49,2008/2009,42,41,6,35,-Inf
2007/2008,45,50,2008/2009,43,35,8,27,-Inf
2007/2008,45,51,2008/2009,44,28,5,23,-Inf
2007/2008,45,52,2008/2009,45,28,1,27,-Inf
2007/2008,46,1,2007/2008,47,3,20,17,-Inf
2007/2008,46,2,2007/2008,48,4,8,4,-Inf
2007/2008,46,3,2007/2008,49,3,3,0,-0.5333609815712563
2007/2008,46,4,2007/2008,50,1,13,12,-Inf
2007/2008,46,5,2007/2008,51,3,4,1,-11.512925464970229
2007/2008,46,6,2007/2008,52,5,1,4,-Inf
2007/2008,46,7,2008/2009,1,2,10,8,-Inf
2007/2008,46,8,2008/2009,2,3,8,5,-11.512925464970229
2007/2008,46,9,2008/2009,3,2,13,11,-Inf
2007/2008,46,10,2008/2009,4,3,10,7,-11.512925464970229
2007/2008,46,11,2008/2009,5,2,21,19,-Inf
2007/2008,46,12,2008/2009,6,2,18,16,-Inf
2007/2008,46,13,2008/2009,7,3,21,18,-Inf
2007/2008,46,14,2008/2009,8,4,34,30,-Inf
2007/2008,46,15,2008/2009,9,3,25,22,-Inf
2007/2008,46,16,2008/2009,10,4,34,30,-Inf
2007/2008,46,17,2008/2009,11,4,33,29,-Inf
2007/2008,46,18,2008/2009,12,4,40,36,-Inf
2007/2008,46,19,2008/2009,13,7,42,35,-11.512925464970229
2007/2008,46,20,2008/2009,14,6,36,30,-Inf
2007/2008,46,21,2008/2009,15,15,72,57,-Inf
2007/2008,46,22,2008/2009,16,11,75,64,-Inf
2007/2008,46,23,2008/2009,17,9,76,67,-Inf
2007/2008,46,24,2008/2009,18,9,92,83,-Inf
2007/2008,46,25,2008/2009,19,12,71,59,-Inf
2007/2008,46,26,2008/2009,20,13,112,99,-Inf
2007/2008,46,27,2008/2009,21,13,106,93,-Inf
2007/2008,46,28,2008/2009,22,13,101,88,-Inf
2007/2008,46,29,2008/2009,23,20,170,150,-Inf
2007/2008,46,30,2008/2009,24,28,135,107,-Inf
2007/2008,46,31,2008/2009,25,45,106,61,-Inf
2007/2008,46,32,2008/2009,26,28,68,40,-Inf
2007/2008,46,33,2008/2009,27,34,48,14,-Inf
2007/2008,46,34,2008/2009,28,41,48,7,-Inf
2007/2008,46,35,2008/2009,29,36,26,10,-Inf
2007/2008,46,36,2008/2009,30,38,33,5,-Inf
2007/2008,46,37,2008/2009,31,48,29,19,-Inf
2007/2008,46,38,2008/2009,32,27,17,10,-Inf
2007/2008,46,39,2008/2009,33,23,12,11,-11.512925464970229
2007/2008,46,40,2008/2009,34,28,13,15,-Inf
2007/2008,46,41,2008/2009,35,42,17,25,-Inf
2007/2008,46,42,2008/2009,36,30,15,15,-Inf
2007/2008,46,43,2008/2009,37,18,14,4,-Inf
2007/2008,46,44,2008/2009,38,38,15,23,-Inf
2007/2008,46,45,2008/2009,39,28,10,18,-Inf
2007/2008,46,46,2008/2009,40,36,9,27,-Inf
2007/2008,46,47,2008/2009,41,44,2,42,-Inf
2007/2008,46,48,2008/2009,42,41,6,35,-Inf
2007/2008,46,49,2008/2009,43,35,8,27,-Inf
2007/2008,46,50,2008/2009,44,28,5,23,-Inf
2007/2008,46,51,2008/2009,45,28,1,27,-Inf
2007/2008,46,52,2008/2009,46,22,2,20,-Inf
2007/2008,47,1,2007/2008,48,4,8,4,-Inf
2007/2008,47,2,2007/2008,49,3,3,0,-0.5520817402813432
2007/2008,47,3,2007/2008,50,1,13,12,-10.819778284410283
2007/2008,47,4,2007/2008,51,3,4,1,-10.819778284410283
2007/2008,47,5,2007/2008,52,5,1,4,-Inf
2007/2008,47,6,2008/2009,1,2,10,8,-Inf
2007/2008,47,7,2008/2009,2,3,8,5,-11.512925464970229
2007/2008,47,8,2008/2009,3,2,13,11,-Inf
2007/2008,47,9,2008/2009,4,3,10,7,-Inf
2007/2008,47,10,2008/2009,5,2,21,19,-Inf
2007/2008,47,11,2008/2009,6,2,18,16,-Inf
2007/2008,47,12,2008/2009,7,3,21,18,-Inf
2007/2008,47,13,2008/2009,8,4,34,30,-Inf
2007/2008,47,14,2008/2009,9,3,25,22,-Inf
2007/2008,47,15,2008/2009,10,4,34,30,-Inf
2007/2008,47,16,2008/2009,11,4,33,29,-Inf
2007/2008,47,17,2008/2009,12,4,40,36,-Inf
2007/2008,47,18,2008/2009,13,7,42,35,-Inf
2007/2008,47,19,2008/2009,14,6,36,30,-Inf
2007/2008,47,20,2008/2009,15,15,72,57,-Inf
2007/2008,47,21,2008/2009,16,11,75,64,-Inf
2007/2008,47,22,2008/2009,17,9,76,67,-Inf
2007/2008,47,23,2008/2009,18,9,92,83,-Inf
2007/2008,47,24,2008/2009,19,12,71,59,-Inf
2007/2008,47,25,2008/2009,20,13,112,99,-Inf
2007/2008,47,26,2008/2009,21,13,106,93,-Inf
2007/2008,47,27,2008/2009,22,13,101,88,-Inf
2007/2008,47,28,2008/2009,23,20,170,150,-Inf
2007/2008,47,29,2008/2009,24,28,135,107,-Inf
2007/2008,47,30,2008/2009,25,45,106,61,-Inf
2007/2008,47,31,2008/2009,26,28,68,40,-Inf
2007/2008,47,32,2008/2009,27,34,48,14,-Inf
2007/2008,47,33,2008/2009,28,41,48,7,-Inf
2007/2008,47,34,2008/2009,29,36,26,10,-Inf
2007/2008,47,35,2008/2009,30,38,33,5,-11.512925464970229
2007/2008,47,36,2008/2009,31,48,29,19,-Inf
2007/2008,47,37,2008/2009,32,27,17,10,-Inf
2007/2008,47,38,2008/2009,33,23,12,11,-Inf
2007/2008,47,39,2008/2009,34,28,13,15,-Inf
2007/2008,47,40,2008/2009,35,42,17,25,-Inf
2007/2008,47,41,2008/2009,36,30,15,15,-Inf
2007/2008,47,42,2008/2009,37,18,14,4,-11.512925464970229
2007/2008,47,43,2008/2009,38,38,15,23,-Inf
2007/2008,47,44,2008/2009,39,28,10,18,-Inf
2007/2008,47,45,2008/2009,40,36,9,27,-Inf
2007/2008,47,46,2008/2009,41,44,2,42,-Inf
2007/2008,47,47,2008/2009,42,41,6,35,-Inf
2007/2008,47,48,2008/2009,43,35,8,27,-Inf
2007/2008,47,49,2008/2009,44,28,5,23,-Inf
2007/2008,47,50,2008/2009,45,28,1,27,-Inf
2007/2008,47,51,2008/2009,46,22,2,20,-Inf
2007/2008,47,52,2008/2009,47,26,3,23,-Inf
2007/2008,48,1,2007/2008,49,3,3,0,-0.5755241577049279
2007/2008,48,2,2007/2008,50,1,13,12,-Inf
2007/2008,48,3,2007/2008,51,3,4,1,-11.512925464970229
2007/2008,48,4,2007/2008,52,5,1,4,-Inf
2007/2008,48,5,2008/2009,1,2,10,8,-Inf
2007/2008,48,6,2008/2009,2,3,8,5,-11.512925464970229
2007/2008,48,7,2008/2009,3,2,13,11,-Inf
2007/2008,48,8,2008/2009,4,3,10,7,-Inf
2007/2008,48,9,2008/2009,5,2,21,19,-Inf
2007/2008,48,10,2008/2009,6,2,18,16,-Inf
2007/2008,48,11,2008/2009,7,3,21,18,-Inf
2007/2008,48,12,2008/2009,8,4,34,30,-Inf
2007/2008,48,13,2008/2009,9,3,25,22,-Inf
2007/2008,48,14,2008/2009,10,4,34,30,-Inf
2007/2008,48,15,2008/2009,11,4,33,29,-Inf
2007/2008,48,16,2008/2009,12,4,40,36,-Inf
2007/2008,48,17,2008/2009,13,7,42,35,-Inf
2007/2008,48,18,2008/2009,14,6,36,30,-Inf
2007/2008,48,19,2008/2009,15,15,72,57,-Inf
2007/2008,48,20,2008/2009,16,11,75,64,-Inf
2007/2008,48,21,2008/2009,17,9,76,67,-Inf
2007/2008,48,22,2008/2009,18,9,92,83,-Inf
2007/2008,48,23,2008/2009,19,12,71,59,-Inf
2007/2008,48,24,2008/2009,20,13,112,99,-Inf
2007/2008,48,25,2008/2009,21,13,106,93,-Inf
2007/2008,48,26,2008/2009,22,13,101,88,-Inf
2007/2008,48,27,2008/2009,23,20,170,150,-Inf
2007/2008,48,28,2008/2009,24,28,135,107,-Inf
2007/2008,48,29,2008/2009,25,45,106,61,-Inf
2007/2008,48,30,2008/2009,26,28,68,40,-Inf
2007/2008,48,31,2008/2009,27,34,48,14,-Inf
2007/2008,48,32,2008/2009,28,41,48,7,-11.512925464970229
2007/2008,48,33,2008/2009,29,36,26,10,-Inf
2007/2008,48,34,2008/2009,30,38,33,5,-11.512925464970229
2007/2008,48,35,2008/2009,31,48,29,19,-Inf
2007/2008,48,36,2008/2009,32,27,17,10,-Inf
2007/2008,48,37,2008/2009,33,23,12,11,-Inf
2007/2008,48,38,2008/2009,34,28,13,15,-Inf
2007/2008,48,39,2008/2009,35,42,17,25,-Inf
2007/2008,48,40,2008/2009,36,30,15,15,-Inf
2007/2008,48,41,2008/2009,37,18,14,4,-11.512925464970229
2007/2008,48,42,2008/2009,38,38,15,23,-Inf
2007/2008,48,43,2008/2009,39,28,10,18,-Inf
2007/2008,48,44,2008/2009,40,36,9,27,-Inf
2007/2008,48,45,2008/2009,41,44,2,42,-Inf
2007/2008,48,46,2008/2009,42,41,6,35,-Inf
2007/2008,48,47,2008/2009,43,35,8,27,-Inf
2007/2008,48,48,2008/2009,44,28,5,23,-Inf
2007/2008,48,49,2008/2009,45,28,1,27,-Inf
2007/2008,48,50,2008/2009,46,22,2,20,-Inf
2007/2008,48,51,2008/2009,47,26,3,23,-Inf
2007/2008,48,52,2008/2009,48,24,4,20,-Inf
2007/2008,49,1,2007/2008,50,1,13,12,-Inf
2007/2008,49,2,2007/2008,51,3,4,1,-10.819778284410283
2007/2008,49,3,2007/2008,52,5,1,4,-Inf
2007/2008,49,4,2008/2009,1,2,10,8,-11.512925464970229
2007/2008,49,5,2008/2009,2,3,8,5,-Inf
2007/2008,49,6,2008/2009,3,2,13,11,-Inf
2007/2008,49,7,2008/2009,4,3,10,7,-Inf
2007/2008,49,8,2008/2009,5,2,21,19,-Inf
2007/2008,49,9,2008/2009,6,2,18,16,-Inf
2007/2008,49,10,2008/2009,7,3,21,18,-Inf
2007/2008,49,11,2008/2009,8,4,34,30,-Inf
2007/2008,49,12,2008/2009,9,3,25,22,-Inf
2007/2008,49,13,2008/2009,10,4,34,30,-Inf
2007/2008,49,14,2008/2009,11,4,33,29,-Inf
2007/2008,49,15,2008/2009,12,4,40,36,-11.512925464970229
2007/2008,49,16,2008/2009,13,7,42,35,-Inf
2007/2008,49,17,2008/2009,14,6,36,30,-Inf
2007/2008,49,18,2008/2009,15,15,72,57,-Inf
2007/2008,49,19,2008/2009,16,11,75,64,-Inf
2007/2008,49,20,2008/2009,17,9,76,67,-Inf
2007/2008,49,21,2008/2009,18,9,92,83,-Inf
2007/2008,49,22,2008/2009,19,12,71,59,-Inf
2007/2008,49,23,2008/2009,20,13,112,99,-Inf
2007/2008,49,24,2008/2009,21,13,106,93,-Inf
2007/2008,49,25,2008/2009,22,13,101,88,-Inf
2007/2008,49,26,2008/2009,23,20,170,150,-Inf
2007/2008,49,27,2008/2009,24,28,135,107,-Inf
2007/2008,49,28,2008/2009,25,45,106,61,-Inf
2007/2008,49,29,2008/2009,26,28,68,40,-Inf
2007/2008,49,30,2008/2009,27,34,48,14,-Inf
2007/2008,49,31,2008/2009,28,41,48,7,-Inf
2007/2008,49,32,2008/2009,29,36,26,10,-Inf
2007/2008,49,33,2008/2009,30,38,33,5,-Inf
2007/2008,49,34,2008/2009,31,48,29,19,-Inf
2007/2008,49,35,2008/2009,32,27,17,10,-11.512925464970229
2007/2008,49,36,2008/2009,33,23,12,11,-Inf
2007/2008,49,37,2008/2009,34,28,13,15,-Inf
2007/2008,49,38,2008/2009,35,42,17,25,-Inf
2007/2008,49,39,2008/2009,36,30,15,15,-Inf
2007/2008,49,40,2008/2009,37,18,14,4,-Inf
2007/2008,49,41,2008/2009,38,38,15,23,-Inf
2007/2008,49,42,2008/2009,39,28,10,18,-Inf
2007/2008,49,43,2008/2009,40,36,9,27,-Inf
2007/2008,49,44,2008/2009,41,44,2,42,-Inf
2007/2008,49,45,2008/2009,42,41,6,35,-Inf
2007/2008,49,46,2008/2009,43,35,8,27,-Inf
2007/2008,49,47,2008/2009,44,28,5,23,-Inf
2007/2008,49,48,2008/2009,45,28,1,27,-Inf
2007/2008,49,49,2008/2009,46,22,2,20,-Inf
2007/2008,49,50,2008/2009,47,26,3,23,-Inf
2007/2008,49,51,2008/2009,48,24,4,20,-Inf
2007/2008,49,52,2008/2009,49,9,3,6,-Inf
2007/2008,4,1,2007/2008,5,21,11,10,-Inf
2007/2008,4,2,2007/2008,6,18,5,13,-Inf
2007/2008,4,3,2007/2008,7,21,5,16,-Inf
2007/2008,4,4,2007/2008,8,34,6,28,-Inf
2007/2008,4,5,2007/2008,9,25,6,19,-Inf
2007/2008,4,6,2007/2008,10,34,4,30,-Inf
2007/2008,4,7,2007/2008,11,33,4,29,-Inf
2007/2008,4,8,2007/2008,12,40,8,32,-Inf
2007/2008,4,9,2007/2008,13,42,14,28,-Inf
2007/2008,4,10,2007/2008,14,36,12,24,-Inf
2007/2008,4,11,2007/2008,15,72,16,56,-Inf
2007/2008,4,12,2007/2008,16,75,10,65,-Inf
2007/2008,4,13,2007/2008,17,76,16,60,-Inf
2007/2008,4,14,2007/2008,18,92,18,74,-Inf
2007/2008,4,15,2007/2008,19,71,15,56,-Inf
2007/2008,4,16,2007/2008,20,112,23,89,-Inf
2007/2008,4,17,2007/2008,21,106,17,89,-Inf
2007/2008,4,18,2007/2008,22,101,33,68,-Inf
2007/2008,4,19,2007/2008,23,170,15,155,-Inf
2007/2008,4,20,2007/2008,24,135,13,122,-Inf
2007/2008,4,21,2007/2008,25,106,11,95,-Inf
2007/2008,4,22,2007/2008,26,68,14,54,-Inf
2007/2008,4,23,2007/2008,27,48,17,31,-Inf
2007/2008,4,24,2007/2008,28,48,19,29,-Inf
2007/2008,4,25,2007/2008,29,26,20,6,-Inf
2007/2008,4,26,2007/2008,30,33,12,21,-Inf
2007/2008,4,27,2007/2008,31,29,21,8,-Inf
2007/2008,4,28,2007/2008,32,17,7,10,-Inf
2007/2008,4,29,2007/2008,33,12,19,7,-11.512925464970229
2007/2008,4,30,2007/2008,34,13,10,3,-Inf
2007/2008,4,31,2007/2008,35,17,13,4,-Inf
2007/2008,4,32,2007/2008,36,15,10,5,-Inf
2007/2008,4,33,2007/2008,37,14,8,6,-Inf
2007/2008,4,34,2007/2008,38,15,21,6,-Inf
2007/2008,4,35,2007/2008,39,10,11,1,-11.512925464970229
2007/2008,4,36,2007/2008,40,9,9,0,-0.3491462132323342
2007/2008,4,37,2007/2008,41,2,14,12,-Inf
2007/2008,4,38,2007/2008,42,6,14,8,-Inf
2007/2008,4,39,2007/2008,43,8,15,7,-Inf
2007/2008,4,40,2007/2008,44,5,18,13,-Inf
2007/2008,4,41,2007/2008,45,1,16,15,-Inf
2007/2008,4,42,2007/2008,46,2,12,10,-11.512925464970229
2007/2008,4,43,2007/2008,47,3,20,17,-Inf
2007/2008,4,44,2007/2008,48,4,8,4,-11.512925464970229
2007/2008,4,45,2007/2008,49,3,3,0,-0.3526829226691959
2007/2008,4,46,2007/2008,50,1,13,12,-Inf
2007/2008,4,47,2007/2008,51,3,4,1,-Inf
2007/2008,4,48,2007/2008,52,5,1,4,-11.512925464970229
2007/2008,4,49,2008/2009,1,2,10,8,-11.512925464970229
2007/2008,4,50,2008/2009,2,3,8,5,-Inf
2007/2008,4,51,2008/2009,3,2,13,11,-Inf
2007/2008,4,52,2008/2009,4,3,10,7,-Inf
2007/2008,50,1,2007/2008,51,3,4,1,-10.819778284410283
2007/2008,50,2,2007/2008,52,5,1,4,-Inf
2007/2008,50,3,2008/2009,1,2,10,8,-Inf
2007/2008,50,4,2008/2009,2,3,8,5,-10.819778284410283
2007/2008,50,5,2008/2009,3,2,13,11,-Inf
2007/2008,50,6,2008/2009,4,3,10,7,-11.512925464970229
2007/2008,50,7,2008/2009,5,2,21,19,-11.512925464970229
2007/2008,50,8,2008/2009,6,2,18,16,-Inf
2007/2008,50,9,2008/2009,7,3,21,18,-11.512925464970229
2007/2008,50,10,2008/2009,8,4,34,30,-11.512925464970229
2007/2008,50,11,2008/2009,9,3,25,22,-Inf
2007/2008,50,12,2008/2009,10,4,34,30,-Inf
2007/2008,50,13,2008/2009,11,4,33,29,-Inf
2007/2008,50,14,2008/2009,12,4,40,36,-Inf
2007/2008,50,15,2008/2009,13,7,42,35,-Inf
2007/2008,50,16,2008/2009,14,6,36,30,-Inf
2007/2008,50,17,2008/2009,15,15,72,57,-Inf
2007/2008,50,18,2008/2009,16,11,75,64,-Inf
2007/2008,50,19,2008/2009,17,9,76,67,-Inf
2007/2008,50,20,2008/2009,18,9,92,83,-Inf
2007/2008,50,21,2008/2009,19,12,71,59,-Inf
2007/2008,50,22,2008/2009,20,13,112,99,-Inf
2007/2008,50,23,2008/2009,21,13,106,93,-Inf
2007/2008,50,24,2008/2009,22,13,101,88,-Inf
2007/2008,50,25,2008/2009,23,20,170,150,-Inf
2007/2008,50,26,2008/2009,24,28,135,107,-Inf
2007/2008,50,27,2008/2009,25,45,106,61,-Inf
2007/2008,50,28,2008/2009,26,28,68,40,-Inf
2007/2008,50,29,2008/2009,27,34,48,14,-Inf
2007/2008,50,30,2008/2009,28,41,48,7,-Inf
2007/2008,50,31,2008/2009,29,36,26,10,-Inf
2007/2008,50,32,2008/2009,30,38,33,5,-Inf
2007/2008,50,33,2008/2009,31,48,29,19,-Inf
2007/2008,50,34,2008/2009,32,27,17,10,-Inf
2007/2008,50,35,2008/2009,33,23,12,11,-Inf
2007/2008,50,36,2008/2009,34,28,13,15,-Inf
2007/2008,50,37,2008/2009,35,42,17,25,-Inf
2007/2008,50,38,2008/2009,36,30,15,15,-Inf
2007/2008,50,39,2008/2009,37,18,14,4,-Inf
2007/2008,50,40,2008/2009,38,38,15,23,-Inf
2007/2008,50,41,2008/2009,39,28,10,18,-Inf
2007/2008,50,42,2008/2009,40,36,9,27,-Inf
2007/2008,50,43,2008/2009,41,44,2,42,-Inf
2007/2008,50,44,2008/2009,42,41,6,35,-Inf
2007/2008,50,45,2008/2009,43,35,8,27,-Inf
2007/2008,50,46,2008/2009,44,28,5,23,-Inf
2007/2008,50,47,2008/2009,45,28,1,27,-Inf
2007/2008,50,48,2008/2009,46,22,2,20,-Inf
2007/2008,50,49,2008/2009,47,26,3,23,-Inf
2007/2008,50,50,2008/2009,48,24,4,20,-Inf
2007/2008,50,51,2008/2009,49,9,3,6,-Inf
2007/2008,50,52,2008/2009,50,21,1,20,-Inf
2007/2008,51,1,2007/2008,52,5,1,4,-Inf
2007/2008,51,2,2008/2009,1,2,10,8,-11.512925464970229
2007/2008,51,3,2008/2009,2,3,8,5,-Inf
2007/2008,51,4,2008/2009,3,2,13,11,-Inf
2007/2008,51,5,2008/2009,4,3,10,7,-Inf
2007/2008,51,6,2008/2009,5,2,21,19,-Inf
2007/2008,51,7,2008/2009,6,2,18,16,-Inf
2007/2008,51,8,2008/2009,7,3,21,18,-Inf
2007/2008,51,9,2008/2009,8,4,34,30,-10.819778284410283
2007/2008,51,10,2008/2009,9,3,25,22,-Inf
2007/2008,51,11,2008/2009,10,4,34,30,-Inf
2007/2008,51,12,2008/2009,11,4,33,29,-Inf
2007/2008,51,13,2008/2009,12,4,40,36,-Inf
2007/2008,51,14,2008/2009,13,7,42,35,-Inf
2007/2008,51,15,2008/2009,14,6,36,30,-Inf
2007/2008,51,16,2008/2009,15,15,72,57,-Inf
2007/2008,51,17,2008/2009,16,11,75,64,-Inf
2007/2008,51,18,2008/2009,17,9,76,67,-Inf
2007/2008,51,19,2008/2009,18,9,92,83,-Inf
2007/2008,51,20,2008/2009,19,12,71,59,-Inf
2007/2008,51,21,2008/2009,20,13,112,99,-Inf
2007/2008,51,22,2008/2009,21,13,106,93,-Inf
2007/2008,51,23,2008/2009,22,13,101,88,-Inf
2007/2008,51,24,2008/2009,23,20,170,150,-Inf
2007/2008,51,25,2008/2009,24,28,135,107,-Inf
2007/2008,51,26,2008/2009,25,45,106,61,-Inf
2007/2008,51,27,2008/2009,26,28,68,40,-Inf
2007/2008,51,28,2008/2009,27,34,48,14,-Inf
2007/2008,51,29,2008/2009,28,41,48,7,-Inf
2007/2008,51,30,2008/2009,29,36,26,10,-Inf
2007/2008,51,31,2008/2009,30,38,33,5,-Inf
2007/2008,51,32,2008/2009,31,48,29,19,-Inf
2007/2008,51,33,2008/2009,32,27,17,10,-Inf
2007/2008,51,34,2008/2009,33,23,12,11,-Inf
2007/2008,51,35,2008/2009,34,28,13,15,-Inf
2007/2008,51,36,2008/2009,35,42,17,25,-Inf
2007/2008,51,37,2008/2009,36,30,15,15,-Inf
2007/2008,51,38,2008/2009,37,18,14,4,-Inf
2007/2008,51,39,2008/2009,38,38,15,23,-Inf
2007/2008,51,40,2008/2009,39,28,10,18,-Inf
2007/2008,51,41,2008/2009,40,36,9,27,-Inf
2007/2008,51,42,2008/2009,41,44,2,42,-Inf
2007/2008,51,43,2008/2009,42,41,6,35,-Inf
2007/2008,51,44,2008/2009,43,35,8,27,-Inf
2007/2008,51,45,2008/2009,44,28,5,23,-Inf
2007/2008,51,46,2008/2009,45,28,1,27,-Inf
2007/2008,51,47,2008/2009,46,22,2,20,-Inf
2007/2008,51,48,2008/2009,47,26,3,23,-Inf
2007/2008,51,49,2008/2009,48,24,4,20,-Inf
2007/2008,51,50,2008/2009,49,9,3,6,-Inf
2007/2008,51,51,2008/2009,50,21,1,20,-Inf
2007/2008,51,52,2008/2009,51,10,3,7,-Inf
2007/2008,52,1,2008/2009,1,2,10,8,-11.512925464970229
2007/2008,52,2,2008/2009,2,3,8,5,-11.512925464970229
2007/2008,52,3,2008/2009,3,2,13,11,-Inf
2007/2008,52,4,2008/2009,4,3,10,7,-Inf
2007/2008,52,5,2008/2009,5,2,21,19,-Inf
2007/2008,52,6,2008/2009,6,2,18,16,-Inf
2007/2008,52,7,2008/2009,7,3,21,18,-Inf
2007/2008,52,8,2008/2009,8,4,34,30,-Inf
2007/2008,52,9,2008/2009,9,3,25,22,-Inf
2007/2008,52,10,2008/2009,10,4,34,30,-Inf
2007/2008,52,11,2008/2009,11,4,33,29,-Inf
2007/2008,52,12,2008/2009,12,4,40,36,-Inf
2007/2008,52,13,2008/2009,13,7,42,35,-Inf
2007/2008,52,14,2008/2009,14,6,36,30,-Inf
2007/2008,52,15,2008/2009,15,15,72,57,-Inf
2007/2008,52,16,2008/2009,16,11,75,64,-Inf
2007/2008,52,17,2008/2009,17,9,76,67,-Inf
2007/2008,52,18,2008/2009,18,9,92,83,-Inf
2007/2008,52,19,2008/2009,19,12,71,59,-Inf
2007/2008,52,20,2008/2009,20,13,112,99,-11.512925464970229
2007/2008,52,21,2008/2009,21,13,106,93,-Inf
2007/2008,52,22,2008/2009,22,13,101,88,-Inf
2007/2008,52,23,2008/2009,23,20,170,150,-Inf
2007/2008,52,24,2008/2009,24,28,135,107,-11.512925464970229
2007/2008,52,25,2008/2009,25,45,106,61,-Inf
2007/2008,52,26,2008/2009,26,28,68,40,-Inf
2007/2008,52,27,2008/2009,27,34,48,14,-Inf
2007/2008,52,28,2008/2009,28,41,48,7,-Inf
2007/2008,52,29,2008/2009,29,36,26,10,-Inf
2007/2008,52,30,2008/2009,30,38,33,5,-10.819778284410283
2007/2008,52,31,2008/2009,31,48,29,19,-Inf
2007/2008,52,32,2008/2009,32,27,17,10,-Inf
2007/2008,52,33,2008/2009,33,23,12,11,-Inf
2007/2008,52,34,2008/2009,34,28,13,15,-Inf
2007/2008,52,35,2008/2009,35,42,17,25,-Inf
2007/2008,52,36,2008/2009,36,30,15,15,-Inf
2007/2008,52,37,2008/2009,37,18,14,4,-Inf
2007/2008,52,38,2008/2009,38,38,15,23,-Inf
2007/2008,52,39,2008/2009,39,28,10,18,-Inf
2007/2008,52,40,2008/2009,40,36,9,27,-11.512925464970229
2007/2008,52,41,2008/2009,41,44,2,42,-Inf
2007/2008,52,42,2008/2009,42,41,6,35,-Inf
2007/2008,52,43,2008/2009,43,35,8,27,-Inf
2007/2008,52,44,2008/2009,44,28,5,23,-Inf
2007/2008,52,45,2008/2009,45,28,1,27,-Inf
2007/2008,52,46,2008/2009,46,22,2,20,-Inf
2007/2008,52,47,2008/2009,47,26,3,23,-Inf
2007/2008,52,48,2008/2009,48,24,4,20,-Inf
2007/2008,52,49,2008/2009,49,9,3,6,-Inf
2007/2008,52,50,2008/2009,50,21,1,20,-Inf
2007/2008,52,51,2008/2009,51,10,3,7,-Inf
2007/2008,52,52,2008/2009,52,15,5,10,-Inf
2007/2008,5,1,2007/2008,6,18,5,13,-Inf
2007/2008,5,2,2007/2008,7,21,5,16,-Inf
2007/2008,5,3,2007/2008,8,34,6,28,-11.512925464970229
2007/2008,5,4,2007/2008,9,25,6,19,-Inf
2007/2008,5,5,2007/2008,10,34,4,30,-Inf
2007/2008,5,6,2007/2008,11,33,4,29,-Inf
2007/2008,5,7,2007/2008,12,40,8,32,-Inf
2007/2008,5,8,2007/2008,13,42,14,28,-Inf
2007/2008,5,9,2007/2008,14,36,12,24,-Inf
2007/2008,5,10,2007/2008,15,72,16,56,-11.512925464970229
2007/2008,5,11,2007/2008,16,75,10,65,-Inf
2007/2008,5,12,2007/2008,17,76,16,60,-Inf
2007/2008,5,13,2007/2008,18,92,18,74,-Inf
2007/2008,5,14,2007/2008,19,71,15,56,-Inf
2007/2008,5,15,2007/2008,20,112,23,89,-Inf
2007/2008,5,16,2007/2008,21,106,17,89,-Inf
2007/2008,5,17,2007/2008,22,101,33,68,-Inf
2007/2008,5,18,2007/2008,23,170,15,155,-Inf
2007/2008,5,19,2007/2008,24,135,13,122,-Inf
2007/2008,5,20,2007/2008,25,106,11,95,-Inf
2007/2008,5,21,2007/2008,26,68,14,54,-Inf
2007/2008,5,22,2007/2008,27,48,17,31,-Inf
2007/2008,5,23,2007/2008,28,48,19,29,-Inf
2007/2008,5,24,2007/2008,29,26,20,6,-Inf
2007/2008,5,25,2007/2008,30,33,12,21,-Inf
2007/2008,5,26,2007/2008,31,29,21,8,-Inf
2007/2008,5,27,2007/2008,32,17,7,10,-Inf
2007/2008,5,28,2007/2008,33,12,19,7,-Inf
2007/2008,5,29,2007/2008,34,13,10,3,-11.512925464970229
2007/2008,5,30,2007/2008,35,17,13,4,-11.512925464970229
2007/2008,5,31,2007/2008,36,15,10,5,-Inf
2007/2008,5,32,2007/2008,37,14,8,6,-Inf
2007/2008,5,33,2007/2008,38,15,21,6,-Inf
2007/2008,5,34,2007/2008,39,10,11,1,-Inf
2007/2008,5,35,2007/2008,40,9,9,0,-0.354505869511037
2007/2008,5,36,2007/2008,41,2,14,12,-Inf
2007/2008,5,37,2007/2008,42,6,14,8,-Inf
2007/2008,5,38,2007/2008,43,8,15,7,-Inf
2007/2008,5,39,2007/2008,44,5,18,13,-Inf
2007/2008,5,40,2007/2008,45,1,16,15,-11.512925464970229
2007/2008,5,41,2007/2008,46,2,12,10,-Inf
2007/2008,5,42,2007/2008,47,3,20,17,-Inf
2007/2008,5,43,2007/2008,48,4,8,4,-Inf
2007/2008,5,44,2007/2008,49,3,3,0,-0.3546626841778071
2007/2008,5,45,2007/2008,50,1,13,12,-Inf
2007/2008,5,46,2007/2008,51,3,4,1,-10.819778284410283
2007/2008,5,47,2007/2008,52,5,1,4,-11.512925464970229
2007/2008,5,48,2008/2009,1,2,10,8,-Inf
2007/2008,5,49,2008/2009,2,3,8,5,-Inf
2007/2008,5,50,2008/2009,3,2,13,11,-Inf
2007/2008,5,51,2008/2009,4,3,10,7,-11.512925464970229
2007/2008,5,52,2008/2009,5,2,21,19,-Inf
2007/2008,6,1,2007/2008,7,21,5,16,-Inf
2007/2008,6,2,2007/2008,8,34,6,28,-Inf
2007/2008,6,3,2007/2008,9,25,6,19,-Inf
2007/2008,6,4,2007/2008,10,34,4,30,-Inf
2007/2008,6,5,2007/2008,11,33,4,29,-Inf
2007/2008,6,6,2007/2008,12,40,8,32,-Inf
2007/2008,6,7,2007/2008,13,42,14,28,-Inf
2007/2008,6,8,2007/2008,14,36,12,24,-Inf
2007/2008,6,9,2007/2008,15,72,16,56,-Inf
2007/2008,6,10,2007/2008,16,75,10,65,-Inf
2007/2008,6,11,2007/2008,17,76,16,60,-Inf
2007/2008,6,12,2007/2008,18,92,18,74,-Inf
2007/2008,6,13,2007/2008,19,71,15,56,-Inf
2007/2008,6,14,2007/2008,20,112,23,89,-Inf
2007/2008,6,15,2007/2008,21,106,17,89,-Inf
2007/2008,6,16,2007/2008,22,101,33,68,-Inf
2007/2008,6,17,2007/2008,23,170,15,155,-Inf
2007/2008,6,18,2007/2008,24,135,13,122,-Inf
2007/2008,6,19,2007/2008,25,106,11,95,-Inf
2007/2008,6,20,2007/2008,26,68,14,54,-Inf
2007/2008,6,21,2007/2008,27,48,17,31,-Inf
2007/2008,6,22,2007/2008,28,48,19,29,-Inf
2007/2008,6,23,2007/2008,29,26,20,6,-Inf
2007/2008,6,24,2007/2008,30,33,12,21,-Inf
2007/2008,6,25,2007/2008,31,29,21,8,-Inf
2007/2008,6,26,2007/2008,32,17,7,10,-Inf
2007/2008,6,27,2007/2008,33,12,19,7,-Inf
2007/2008,6,28,2007/2008,34,13,10,3,-Inf
2007/2008,6,29,2007/2008,35,17,13,4,-11.512925464970229
2007/2008,6,30,2007/2008,36,15,10,5,-11.512925464970229
2007/2008,6,31,2007/2008,37,14,8,6,-Inf
2007/2008,6,32,2007/2008,38,15,21,6,-Inf
2007/2008,6,33,2007/2008,39,10,11,1,-Inf
2007/2008,6,34,2007/2008,40,9,9,0,-0.35871989056039943
2007/2008,6,35,2007/2008,41,2,14,12,-Inf
2007/2008,6,36,2007/2008,42,6,14,8,-Inf
2007/2008,6,37,2007/2008,43,8,15,7,-Inf
2007/2008,6,38,2007/2008,44,5,18,13,-Inf
2007/2008,6,39,2007/2008,45,1,16,15,-Inf
2007/2008,6,40,2007/2008,46,2,12,10,-Inf
2007/2008,6,41,2007/2008,47,3,20,17,-Inf
2007/2008,6,42,2007/2008,48,4,8,4,-Inf
2007/2008,6,43,2007/2008,49,3,3,0,-0.35693211986276907
2007/2008,6,44,2007/2008,50,1,13,12,-Inf
2007/2008,6,45,2007/2008,51,3,4,1,-Inf
2007/2008,6,46,2007/2008,52,5,1,4,-Inf
2007/2008,6,47,2008/2009,1,2,10,8,-Inf
2007/2008,6,48,2008/2009,2,3,8,5,-Inf
2007/2008,6,49,2008/2009,3,2,13,11,-Inf
2007/2008,6,50,2008/2009,4,3,10,7,-Inf
2007/2008,6,51,2008/2009,5,2,21,19,-Inf
2007/2008,6,52,2008/2009,6,2,18,16,-Inf
2007/2008,7,1,2007/2008,8,34,6,28,-Inf
2007/2008,7,2,2007/2008,9,25,6,19,-11.512925464970229
2007/2008,7,3,2007/2008,10,34,4,30,-Inf
2007/2008,7,4,2007/2008,11,33,4,29,-Inf
2007/2008,7,5,2007/2008,12,40,8,32,-Inf
2007/2008,7,6,2007/2008,13,42,14,28,-Inf
2007/2008,7,7,2007/2008,14,36,12,24,-Inf
2007/2008,7,8,2007/2008,15,72,16,56,-Inf
2007/2008,7,9,2007/2008,16,75,10,65,-Inf
2007/2008,7,10,2007/2008,17,76,16,60,-Inf
2007/2008,7,11,2007/2008,18,92,18,74,-11.512925464970229
2007/2008,7,12,2007/2008,19,71,15,56,-Inf
2007/2008,7,13,2007/2008,20,112,23,89,-Inf
2007/2008,7,14,2007/2008,21,106,17,89,-11.512925464970229
2007/2008,7,15,2007/2008,22,101,33,68,-Inf
2007/2008,7,16,2007/2008,23,170,15,155,-Inf
2007/2008,7,17,2007/2008,24,135,13,122,-Inf
2007/2008,7,18,2007/2008,25,106,11,95,-Inf
2007/2008,7,19,2007/2008,26,68,14,54,-Inf
2007/2008,7,20,2007/2008,27,48,17,31,-Inf
2007/2008,7,21,2007/2008,28,48,19,29,-11.512925464970229
2007/2008,7,22,2007/2008,29,26,20,6,-11.512925464970229
2007/2008,7,23,2007/2008,30,33,12,21,-Inf
2007/2008,7,24,2007/2008,31,29,21,8,-Inf
2007/2008,7,25,2007/2008,32,17,7,10,-Inf
2007/2008,7,26,2007/2008,33,12,19,7,-Inf
2007/2008,7,27,2007/2008,34,13,10,3,-11.512925464970229
2007/2008,7,28,2007/2008,35,17,13,4,-Inf
2007/2008,7,29,2007/2008,36,15,10,5,-Inf
2007/2008,7,30,2007/2008,37,14,8,6,-Inf
2007/2008,7,31,2007/2008,38,15,21,6,-11.512925464970229
2007/2008,7,32,2007/2008,39,10,11,1,-11.512925464970229
2007/2008,7,33,2007/2008,40,9,9,0,-0.35924968431120163
2007/2008,7,34,2007/2008,41,2,14,12,-Inf
2007/2008,7,35,2007/2008,42,6,14,8,-Inf
2007/2008,7,36,2007/2008,43,8,15,7,-Inf
2007/2008,7,37,2007/2008,44,5,18,13,-Inf
2007/2008,7,38,2007/2008,45,1,16,15,-Inf
2007/2008,7,39,2007/2008,46,2,12,10,-Inf
2007/2008,7,40,2007/2008,47,3,20,17,-Inf
2007/2008,7,41,2007/2008,48,4,8,4,-Inf
2007/2008,7,42,2007/2008,49,3,3,0,-0.356589233326277
2007/2008,7,43,2007/2008,50,1,13,12,-Inf
2007/2008,7,44,2007/2008,51,3,4,1,-10.819778284410283
2007/2008,7,45,2007/2008,52,5,1,4,-Inf
2007/2008,7,46,2008/2009,1,2,10,8,-Inf
2007/2008,7,47,2008/2009,2,3,8,5,-Inf
2007/2008,7,48,2008/2009,3,2,13,11,-Inf
2007/2008,7,49,2008/2009,4,3,10,7,-Inf
2007/2008,7,50,2008/2009,5,2,21,19,-Inf
2007/2008,7,51,2008/2009,6,2,18,16,-Inf
2007/2008,7,52,2008/2009,7,3,21,18,-11.512925464970229
2007/2008,8,1,2007/2008,9,25,6,19,-Inf
2007/2008,8,2,2007/2008,10,34,4,30,-Inf
2007/2008,8,3,2007/2008,11,33,4,29,-11.512925464970229
2007/2008,8,4,2007/2008,12,40,8,32,-Inf
2007/2008,8,5,2007/2008,13,42,14,28,-Inf
2007/2008,8,6,2007/2008,14,36,12,24,-Inf
2007/2008,8,7,2007/2008,15,72,16,56,-Inf
2007/2008,8,8,2007/2008,16,75,10,65,-Inf
2007/2008,8,9,2007/2008,17,76,16,60,-Inf
2007/2008,8,10,2007/2008,18,92,18,74,-Inf
2007/2008,8,11,2007/2008,19,71,15,56,-Inf
2007/2008,8,12,2007/2008,20,112,23,89,-Inf
2007/2008,8,13,2007/2008,21,106,17,89,-Inf
2007/2008,8,14,2007/2008,22,101,33,68,-Inf
2007/2008,8,15,2007/2008,23,170,15,155,-Inf
2007/2008,8,16,2007/2008,24,135,13,122,-Inf
2007/2008,8,17,2007/2008,25,106,11,95,-Inf
2007/2008,8,18,2007/2008,26,68,14,54,-Inf
2007/2008,8,19,2007/2008,27,48,17,31,-Inf
2007/2008,8,20,2007/2008,28,48,19,29,-Inf
2007/2008,8,21,2007/2008,29,26,20,6,-Inf
2007/2008,8,22,2007/2008,30,33,12,21,-Inf
2007/2008,8,23,2007/2008,31,29,21,8,-Inf
2007/2008,8,24,2007/2008,32,17,7,10,-Inf
2007/2008,8,25,2007/2008,33,12,19,7,-Inf
2007/2008,8,26,2007/2008,34,13,10,3,-11.512925464970229
2007/2008,8,27,2007/2008,35,17,13,4,-Inf
2007/2008,8,28,2007/2008,36,15,10,5,-Inf
2007/2008,8,29,2007/2008,37,14,8,6,-Inf
2007/2008,8,30,2007/2008,38,15,21,6,-Inf
2007/2008,8,31,2007/2008,39,10,11,1,-Inf
2007/2008,8,32,2007/2008,40,9,9,0,-0.36216139559903127
2007/2008,8,33,2007/2008,41,2,14,12,-Inf
2007/2008,8,34,2007/2008,42,6,14,8,-11.512925464970229
2007/2008,8,35,2007/2008,43,8,15,7,-Inf
2007/2008,8,36,2007/2008,44,5,18,13,-Inf
2007/2008,8,37,2007/2008,45,1,16,15,-Inf
2007/2008,8,38,2007/2008,46,2,12,10,-Inf
2007/2008,8,39,2007/2008,47,3,20,17,-Inf
2007/2008,8,40,2007/2008,48,4,8,4,-Inf
2007/2008,8,41,2007/2008,49,3,3,0,-0.3585195012318909
2007/2008,8,42,2007/2008,50,1,13,12,-Inf
2007/2008,8,43,2007/2008,51,3,4,1,-11.512925464970229
2007/2008,8,44,2007/2008,52,5,1,4,-Inf
2007/2008,8,45,2008/2009,1,2,10,8,-Inf
2007/2008,8,46,2008/2009,2,3,8,5,-Inf
2007/2008,8,47,2008/2009,3,2,13,11,-Inf
2007/2008,8,48,2008/2009,4,3,10,7,-Inf
2007/2008,8,49,2008/2009,5,2,21,19,-Inf
2007/2008,8,50,2008/2009,6,2,18,16,-Inf
2007/2008,8,51,2008/2009,7,3,21,18,-Inf
2007/2008,8,52,2008/2009,8,4,34,30,-Inf
2007/2008,9,1,2007/2008,10,34,4,30,-Inf
2007/2008,9,2,2007/2008,11,33,4,29,-Inf
2007/2008,9,3,2007/2008,12,40,8,32,-11.512925464970229
2007/2008,9,4,2007/2008,13,42,14,28,-Inf
2007/2008,9,5,2007/2008,14,36,12,24,-Inf
2007/2008,9,6,2007/2008,15,72,16,56,-Inf
2007/2008,9,7,2007/2008,16,75,10,65,-Inf
2007/2008,9,8,2007/2008,17,76,16,60,-Inf
2007/2008,9,9,2007/2008,18,92,18,74,-Inf
2007/2008,9,10,2007/2008,19,71,15,56,-Inf
2007/2008,9,11,2007/2008,20,112,23,89,-Inf
2007/2008,9,12,2007/2008,21,106,17,89,-Inf
2007/2008,9,13,2007/2008,22,101,33,68,-11.512925464970229
2007/2008,9,14,2007/2008,23,170,15,155,-Inf
2007/2008,9,15,2007/2008,24,135,13,122,-Inf
2007/2008,9,16,2007/2008,25,106,11,95,-Inf
2007/2008,9,17,2007/2008,26,68,14,54,-Inf
2007/2008,9,18,2007/2008,27,48,17,31,-Inf
2007/2008,9,19,2007/2008,28,48,19,29,-Inf
2007/2008,9,20,2007/2008,29,26,20,6,-11.512925464970229
2007/2008,9,21,2007/2008,30,33,12,21,-Inf
2007/2008,9,22,2007/2008,31,29,21,8,-11.512925464970229
2007/2008,9,23,2007/2008,32,17,7,10,-Inf
2007/2008,9,24,2007/2008,33,12,19,7,-Inf
2007/2008,9,25,2007/2008,34,13,10,3,-Inf
2007/2008,9,26,2007/2008,35,17,13,4,-Inf
2007/2008,9,27,2007/2008,36,15,10,5,-Inf
2007/2008,9,28,2007/2008,37,14,8,6,-11.512925464970229
2007/2008,9,29,2007/2008,38,15,21,6,-Inf
2007/2008,9,30,2007/2008,39,10,11,1,-11.512925464970229
2007/2008,9,31,2007/2008,40,9,9,0,-0.3630380024682687
2007/2008,9,32,2007/2008,41,2,14,12,-11.512925464970229
2007/2008,9,33,2007/2008,42,6,14,8,-Inf
2007/2008,9,34,2007/2008,43,8,15,7,-Inf
2007/2008,9,35,2007/2008,44,5,18,13,-Inf
2007/2008,9,36,2007/2008,45,1,16,15,-Inf
2007/2008,9,37,2007/2008,46,2,12,10,-Inf
2007/2008,9,38,2007/2008,47,3,20,17,-Inf
2007/2008,9,39,2007/2008,48,4,8,4,-Inf
2007/2008,9,40,2007/2008,49,3,3,0,-0.3573608934340182
2007/2008,9,41,2007/2008,50,1,13,12,-Inf
2007/2008,9,42,2007/2008,51,3,4,1,-Inf
2007/2008,9,43,2007/2008,52,5,1,4,-Inf
2007/2008,9,44,2008/2009,1,2,10,8,-Inf
2007/2008,9,45,2008/2009,2,3,8,5,-Inf
2007/2008,9,46,2008/2009,3,2,13,11,-Inf
2007/2008,9,47,2008/2009,4,3,10,7,-Inf
2007/2008,9,48,2008/2009,5,2,21,19,-Inf
2007/2008,9,49,2008/2009,6,2,18,16,-Inf
2007/2008,9,50,2008/2009,7,3,21,18,-Inf
2007/2008,9,51,2008/2009,8,4,34,30,-Inf
2007/2008,9,52,2008/2009,9,3,25,22,-Inf
2008/2009,10,1,2008/2009,11,4,33,29,-Inf
2008/2009,10,2,2008/2009,12,4,40,36,-Inf
2008/2009,10,3,2008/2009,13,7,42,35,-Inf
2008/2009,10,4,2008/2009,14,6,36,30,-Inf
2008/2009,10,5,2008/2009,15,15,72,57,-Inf
2008/2009,10,6,2008/2009,16,11,75,64,-Inf
2008/2009,10,7,2008/2009,17,9,76,67,-Inf
2008/2009,10,8,2008/2009,18,9,92,83,-Inf
2008/2009,10,9,2008/2009,19,12,71,59,-Inf
2008/2009,10,10,2008/2009,20,13,112,99,-Inf
2008/2009,10,11,2008/2009,21,13,106,93,-Inf
2008/2009,10,12,2008/2009,22,13,101,88,-Inf
2008/2009,10,13,2008/2009,23,20,170,150,-Inf
2008/2009,10,14,2008/2009,24,28,135,107,-Inf
2008/2009,10,15,2008/2009,25,45,106,61,-Inf
2008/2009,10,16,2008/2009,26,28,68,40,-Inf
2008/2009,10,17,2008/2009,27,34,48,14,-Inf
2008/2009,10,18,2008/2009,28,41,48,7,-Inf
2008/2009,10,19,2008/2009,29,36,26,10,-Inf
2008/2009,10,20,2008/2009,30,38,33,5,-Inf
2008/2009,10,21,2008/2009,31,48,29,19,-Inf
2008/2009,10,22,2008/2009,32,27,17,10,-Inf
2008/2009,10,23,2008/2009,33,23,12,11,-Inf
2008/2009,10,24,2008/2009,34,28,13,15,-Inf
2008/2009,10,25,2008/2009,35,42,17,25,-Inf
2008/2009,10,26,2008/2009,36,30,15,15,-Inf
2008/2009,10,27,2008/2009,37,18,14,4,-Inf
2008/2009,10,28,2008/2009,38,38,15,23,-Inf
2008/2009,10,29,2008/2009,39,28,10,18,-Inf
2008/2009,10,30,2008/2009,40,36,9,27,-Inf
2008/2009,10,31,2008/2009,41,44,2,42,-Inf
2008/2009,10,32,2008/2009,42,41,6,35,-Inf
2008/2009,10,33,2008/2009,43,35,8,27,-Inf
2008/2009,10,34,2008/2009,44,28,5,23,-Inf
2008/2009,10,35,2008/2009,45,28,1,27,-Inf
2008/2009,10,36,2008/2009,46,22,2,20,-Inf
2008/2009,10,37,2008/2009,47,26,3,23,-Inf
2008/2009,10,38,2008/2009,48,24,4,20,-Inf
2008/2009,10,39,2008/2009,49,9,3,6,-Inf
2008/2009,10,40,2008/2009,50,21,1,20,-Inf
2008/2009,10,41,2008/2009,51,10,3,7,-Inf
2008/2009,10,42,2008/2009,52,15,5,10,-Inf
2008/2009,11,1,2008/2009,12,4,40,36,-Inf
2008/2009,11,2,2008/2009,13,7,42,35,-Inf
2008/2009,11,3,2008/2009,14,6,36,30,-Inf
2008/2009,11,4,2008/2009,15,15,72,57,-Inf
2008/2009,11,5,2008/2009,16,11,75,64,-Inf
2008/2009,11,6,2008/2009,17,9,76,67,-Inf
2008/2009,11,7,2008/2009,18,9,92,83,-Inf
2008/2009,11,8,2008/2009,19,12,71,59,-Inf
2008/2009,11,9,2008/2009,20,13,112,99,-Inf
2008/2009,11,10,2008/2009,21,13,106,93,-Inf
2008/2009,11,11,2008/2009,22,13,101,88,-Inf
2008/2009,11,12,2008/2009,23,20,170,150,-Inf
2008/2009,11,13,2008/2009,24,28,135,107,-Inf
2008/2009,11,14,2008/2009,25,45,106,61,-Inf
2008/2009,11,15,2008/2009,26,28,68,40,-Inf
2008/2009,11,16,2008/2009,27,34,48,14,-Inf
2008/2009,11,17,2008/2009,28,41,48,7,-Inf
2008/2009,11,18,2008/2009,29,36,26,10,-Inf
2008/2009,11,19,2008/2009,30,38,33,5,-Inf
2008/2009,11,20,2008/2009,31,48,29,19,-Inf
2008/2009,11,21,2008/2009,32,27,17,10,-Inf
2008/2009,11,22,2008/2009,33,23,12,11,-Inf
2008/2009,11,23,2008/2009,34,28,13,15,-Inf
2008/2009,11,24,2008/2009,35,42,17,25,-Inf
2008/2009,11,25,2008/2009,36,30,15,15,-Inf
2008/2009,11,26,2008/2009,37,18,14,4,-Inf
2008/2009,11,27,2008/2009,38,38,15,23,-Inf
2008/2009,11,28,2008/2009,39,28,10,18,-11.512925464970229
2008/2009,11,29,2008/2009,40,36,9,27,-Inf
2008/2009,11,30,2008/2009,41,44,2,42,-Inf
2008/2009,11,31,2008/2009,42,41,6,35,-Inf
2008/2009,11,32,2008/2009,43,35,8,27,-Inf
2008/2009,11,33,2008/2009,44,28,5,23,-Inf
2008/2009,11,34,2008/2009,45,28,1,27,-Inf
2008/2009,11,35,2008/2009,46,22,2,20,-Inf
2008/2009,11,36,2008/2009,47,26,3,23,-Inf
2008/2009,11,37,2008/2009,48,24,4,20,-Inf
2008/2009,11,38,2008/2009,49,9,3,6,-Inf
2008/2009,11,39,2008/2009,50,21,1,20,-Inf
2008/2009,11,40,2008/2009,51,10,3,7,-Inf
2008/2009,11,41,2008/2009,52,15,5,10,-Inf
2008/2009,12,1,2008/2009,13,7,42,35,-Inf
2008/2009,12,2,2008/2009,14,6,36,30,-Inf
2008/2009,12,3,2008/2009,15,15,72,57,-Inf
2008/2009,12,4,2008/2009,16,11,75,64,-Inf
2008/2009,12,5,2008/2009,17,9,76,67,-11.512925464970229
2008/2009,12,6,2008/2009,18,9,92,83,-Inf
2008/2009,12,7,2008/2009,19,12,71,59,-Inf
2008/2009,12,8,2008/2009,20,13,112,99,-Inf
2008/2009,12,9,2008/2009,21,13,106,93,-Inf
2008/2009,12,10,2008/2009,22,13,101,88,-Inf
2008/2009,12,11,2008/2009,23,20,170,150,-Inf
2008/2009,12,12,2008/2009,24,28,135,107,-Inf
2008/2009,12,13,2008/2009,25,45,106,61,-Inf
2008/2009,12,14,2008/2009,26,28,68,40,-Inf
2008/2009,12,15,2008/2009,27,34,48,14,-Inf
2008/2009,12,16,2008/2009,28,41,48,7,-Inf
2008/2009,12,17,2008/2009,29,36,26,10,-Inf
2008/2009,12,18,2008/2009,30,38,33,5,-Inf
2008/2009,12,19,2008/2009,31,48,29,19,-Inf
2008/2009,12,20,2008/2009,32,27,17,10,-Inf
2008/2009,12,21,2008/2009,33,23,12,11,-Inf
2008/2009,12,22,2008/2009,34,28,13,15,-Inf
2008/2009,12,23,2008/2009,35,42,17,25,-Inf
2008/2009,12,24,2008/2009,36,30,15,15,-Inf
2008/2009,12,25,2008/2009,37,18,14,4,-Inf
2008/2009,12,26,2008/2009,38,38,15,23,-Inf
2008/2009,12,27,2008/2009,39,28,10,18,-Inf
2008/2009,12,28,2008/2009,40,36,9,27,-Inf
2008/2009,12,29,2008/2009,41,44,2,42,-Inf
2008/2009,12,30,2008/2009,42,41,6,35,-Inf
2008/2009,12,31,2008/2009,43,35,8,27,-Inf
2008/2009,12,32,2008/2009,44,28,5,23,-Inf
2008/2009,12,33,2008/2009,45,28,1,27,-Inf
2008/2009,12,34,2008/2009,46,22,2,20,-Inf
2008/2009,12,35,2008/2009,47,26,3,23,-Inf
2008/2009,12,36,2008/2009,48,24,4,20,-Inf
2008/2009,12,37,2008/2009,49,9,3,6,-Inf
2008/2009,12,38,2008/2009,50,21,1,20,-11.512925464970229
2008/2009,12,39,2008/2009,51,10,3,7,-11.512925464970229
2008/2009,12,40,2008/2009,52,15,5,10,-Inf
2008/2009,13,1,2008/2009,14,6,36,30,-Inf
2008/2009,13,2,2008/2009,15,15,72,57,-Inf
2008/2009,13,3,2008/2009,16,11,75,64,-Inf
2008/2009,13,4,2008/2009,17,9,76,67,-Inf
2008/2009,13,5,2008/2009,18,9,92,83,-Inf
2008/2009,13,6,2008/2009,19,12,71,59,-Inf
2008/2009,13,7,2008/2009,20,13,112,99,-Inf
2008/2009,13,8,2008/2009,21,13,106,93,-Inf
2008/2009,13,9,2008/2009,22,13,101,88,-Inf
2008/2009,13,10,2008/2009,23,20,170,150,-Inf
2008/2009,13,11,2008/2009,24,28,135,107,-Inf
2008/2009,13,12,2008/2009,25,45,106,61,-Inf
2008/2009,13,13,2008/2009,26,28,68,40,-Inf
2008/2009,13,14,2008/2009,27,34,48,14,-Inf
2008/2009,13,15,2008/2009,28,41,48,7,-Inf
2008/2009,13,16,2008/2009,29,36,26,10,-Inf
2008/2009,13,17,2008/2009,30,38,33,5,-Inf
2008/2009,13,18,2008/2009,31,48,29,19,-Inf
2008/2009,13,19,2008/2009,32,27,17,10,-Inf
2008/2009,13,20,2008/2009,33,23,12,11,-Inf
2008/2009,13,21,2008/2009,34,28,13,15,-Inf
2008/2009,13,22,2008/2009,35,42,17,25,-Inf
2008/2009,13,23,2008/2009,36,30,15,15,-Inf
2008/2009,13,24,2008/2009,37,18,14,4,-Inf
2008/2009,13,25,2008/2009,38,38,15,23,-Inf
2008/2009,13,26,2008/2009,39,28,10,18,-Inf
2008/2009,13,27,2008/2009,40,36,9,27,-Inf
2008/2009,13,28,2008/2009,41,44,2,42,-Inf
2008/2009,13,29,2008/2009,42,41,6,35,-Inf
2008/2009,13,30,2008/2009,43,35,8,27,-Inf
2008/2009,13,31,2008/2009,44,28,5,23,-Inf
2008/2009,13,32,2008/2009,45,28,1,27,-Inf
2008/2009,13,33,2008/2009,46,22,2,20,-Inf
2008/2009,13,34,2008/2009,47,26,3,23,-Inf
2008/2009,13,35,2008/2009,48,24,4,20,-Inf
2008/2009,13,36,2008/2009,49,9,3,6,-Inf
2008/2009,13,37,2008/2009,50,21,1,20,-Inf
2008/2009,13,38,2008/2009,51,10,3,7,-Inf
2008/2009,13,39,2008/2009,52,15,5,10,-Inf
2008/2009,14,1,2008/2009,15,15,72,57,-Inf
2008/2009,14,2,2008/2009,16,11,75,64,-Inf
2008/2009,14,3,2008/2009,17,9,76,67,-Inf
2008/2009,14,4,2008/2009,18,9,92,83,-Inf
2008/2009,14,5,2008/2009,19,12,71,59,-Inf
2008/2009,14,6,2008/2009,20,13,112,99,-Inf
2008/2009,14,7,2008/2009,21,13,106,93,-Inf
2008/2009,14,8,2008/2009,22,13,101,88,-Inf
2008/2009,14,9,2008/2009,23,20,170,150,-Inf
2008/2009,14,10,2008/2009,24,28,135,107,-Inf
2008/2009,14,11,2008/2009,25,45,106,61,-Inf
2008/2009,14,12,2008/2009,26,28,68,40,-Inf
2008/2009,14,13,2008/2009,27,34,48,14,-Inf
2008/2009,14,14,2008/2009,28,41,48,7,-Inf
2008/2009,14,15,2008/2009,29,36,26,10,-Inf
2008/2009,14,16,2008/2009,30,38,33,5,-Inf
2008/2009,14,17,2008/2009,31,48,29,19,-Inf
2008/2009,14,18,2008/2009,32,27,17,10,-Inf
2008/2009,14,19,2008/2009,33,23,12,11,-Inf
2008/2009,14,20,2008/2009,34,28,13,15,-Inf
2008/2009,14,21,2008/2009,35,42,17,25,-Inf
2008/2009,14,22,2008/2009,36,30,15,15,-Inf
2008/2009,14,23,2008/2009,37,18,14,4,-Inf
2008/2009,14,24,2008/2009,38,38,15,23,-Inf
2008/2009,14,25,2008/2009,39,28,10,18,-Inf
2008/2009,14,26,2008/2009,40,36,9,27,-Inf
2008/2009,14,27,2008/2009,41,44,2,42,-Inf
2008/2009,14,28,2008/2009,42,41,6,35,-Inf
2008/2009,14,29,2008/2009,43,35,8,27,-Inf
2008/2009,14,30,2008/2009,44,28,5,23,-Inf
2008/2009,14,31,2008/2009,45,28,1,27,-Inf
2008/2009,14,32,2008/2009,46,22,2,20,-Inf
2008/2009,14,33,2008/2009,47,26,3,23,-Inf
2008/2009,14,34,2008/2009,48,24,4,20,-Inf
2008/2009,14,35,2008/2009,49,9,3,6,-Inf
2008/2009,14,36,2008/2009,50,21,1,20,-Inf
2008/2009,14,37,2008/2009,51,10,3,7,-Inf
2008/2009,14,38,2008/2009,52,15,5,10,-Inf
2008/2009,15,1,2008/2009,16,11,75,64,-Inf
2008/2009,15,2,2008/2009,17,9,76,67,-Inf
2008/2009,15,3,2008/2009,18,9,92,83,-Inf
2008/2009,15,4,2008/2009,19,12,71,59,-11.512925464970229
2008/2009,15,5,2008/2009,20,13,112,99,-Inf
2008/2009,15,6,2008/2009,21,13,106,93,-Inf
2008/2009,15,7,2008/2009,22,13,101,88,-Inf
2008/2009,15,8,2008/2009,23,20,170,150,-Inf
2008/2009,15,9,2008/2009,24,28,135,107,-Inf
2008/2009,15,10,2008/2009,25,45,106,61,-Inf
2008/2009,15,11,2008/2009,26,28,68,40,-Inf
2008/2009,15,12,2008/2009,27,34,48,14,-Inf
2008/2009,15,13,2008/2009,28,41,48,7,-Inf
2008/2009,15,14,2008/2009,29,36,26,10,-Inf
2008/2009,15,15,2008/2009,30,38,33,5,-Inf
2008/2009,15,16,2008/2009,31,48,29,19,-Inf
2008/2009,15,17,2008/2009,32,27,17,10,-Inf
2008/2009,15,18,2008/2009,33,23,12,11,-Inf
2008/2009,15,19,2008/2009,34,28,13,15,-Inf
2008/2009,15,20,2008/2009,35,42,17,25,-11.512925464970229
2008/2009,15,21,2008/2009,36,30,15,15,-Inf
2008/2009,15,22,2008/2009,37,18,14,4,-Inf
2008/2009,15,23,2008/2009,38,38,15,23,-Inf
2008/2009,15,24,2008/2009,39,28,10,18,-11.512925464970229
2008/2009,15,25,2008/2009,40,36,9,27,-Inf
2008/2009,15,26,2008/2009,41,44,2,42,-Inf
2008/2009,15,27,2008/2009,42,41,6,35,-Inf
2008/2009,15,28,2008/2009,43,35,8,27,-Inf
2008/2009,15,29,2008/2009,44,28,5,23,-Inf
2008/2009,15,30,2008/2009,45,28,1,27,-Inf
2008/2009,15,31,2008/2009,46,22,2,20,-Inf
2008/2009,15,32,2008/2009,47,26,3,23,-Inf
2008/2009,15,33,2008/2009,48,24,4,20,-Inf
2008/2009,15,34,2008/2009,49,9,3,6,-Inf
2008/2009,15,35,2008/2009,50,21,1,20,-Inf
2008/2009,15,36,2008/2009,51,10,3,7,-Inf
2008/2009,15,37,2008/2009,52,15,5,10,-Inf
2008/2009,16,1,2008/2009,17,9,76,67,-Inf
2008/2009,16,2,2008/2009,18,9,92,83,-Inf
2008/2009,16,3,2008/2009,19,12,71,59,-Inf
2008/2009,16,4,2008/2009,20,13,112,99,-Inf
2008/2009,16,5,2008/2009,21,13,106,93,-Inf
2008/2009,16,6,2008/2009,22,13,101,88,-Inf
2008/2009,16,7,2008/2009,23,20,170,150,-Inf
2008/2009,16,8,2008/2009,24,28,135,107,-Inf
2008/2009,16,9,2008/2009,25,45,106,61,-Inf
2008/2009,16,10,2008/2009,26,28,68,40,-Inf
2008/2009,16,11,2008/2009,27,34,48,14,-11.512925464970229
2008/2009,16,12,2008/2009,28,41,48,7,-Inf
2008/2009,16,13,2008/2009,29,36,26,10,-Inf
2008/2009,16,14,2008/2009,30,38,33,5,-Inf
2008/2009,16,15,2008/2009,31,48,29,19,-Inf
2008/2009,16,16,2008/2009,32,27,17,10,-Inf
2008/2009,16,17,2008/2009,33,23,12,11,-Inf
2008/2009,16,18,2008/2009,34,28,13,15,-Inf
2008/2009,16,19,2008/2009,35,42,17,25,-Inf
2008/2009,16,20,2008/2009,36,30,15,15,-Inf
2008/2009,16,21,2008/2009,37,18,14,4,-Inf
2008/2009,16,22,2008/2009,38,38,15,23,-Inf
2008/2009,16,23,2008/2009,39,28,10,18,-Inf
2008/2009,16,24,2008/2009,40,36,9,27,-Inf
2008/2009,16,25,2008/2009,41,44,2,42,-Inf
2008/2009,16,26,2008/2009,42,41,6,35,-Inf
2008/2009,16,27,2008/2009,43,35,8,27,-Inf
2008/2009,16,28,2008/2009,44,28,5,23,-Inf
2008/2009,16,29,2008/2009,45,28,1,27,-Inf
2008/2009,16,30,2008/2009,46,22,2,20,-Inf
2008/2009,16,31,2008/2009,47,26,3,23,-Inf
2008/2009,16,32,2008/2009,48,24,4,20,-Inf
2008/2009,16,33,2008/2009,49,9,3,6,-Inf
2008/2009,16,34,2008/2009,50,21,1,20,-Inf
2008/2009,16,35,2008/2009,51,10,3,7,-11.512925464970229
2008/2009,16,36,2008/2009,52,15,5,10,-Inf
2008/2009,17,1,2008/2009,18,9,92,83,-Inf
2008/2009,17,2,2008/2009,19,12,71,59,-Inf
2008/2009,17,3,2008/2009,20,13,112,99,-Inf
2008/2009,17,4,2008/2009,21,13,106,93,-Inf
2008/2009,17,5,2008/2009,22,13,101,88,-11.512925464970229
2008/2009,17,6,2008/2009,23,20,170,150,-Inf
2008/2009,17,7,2008/2009,24,28,135,107,-Inf
2008/2009,17,8,2008/2009,25,45,106,61,-Inf
2008/2009,17,9,2008/2009,26,28,68,40,-Inf
2008/2009,17,10,2008/2009,27,34,48,14,-Inf
2008/2009,17,11,2008/2009,28,41,48,7,-Inf
2008/2009,17,12,2008/2009,29,36,26,10,-Inf
2008/2009,17,13,2008/2009,30,38,33,5,-Inf
2008/2009,17,14,2008/2009,31,48,29,19,-Inf
2008/2009,17,15,2008/2009,32,27,17,10,-Inf
2008/2009,17,16,2008/2009,33,23,12,11,-Inf
2008/2009,17,17,2008/2009,34,28,13,15,-Inf
2008/2009,17,18,2008/2009,35,42,17,25,-Inf
2008/2009,17,19,2008/2009,36,30,15,15,-Inf
2008/2009,17,20,2008/2009,37,18,14,4,-Inf
2008/2009,17,21,2008/2009,38,38,15,23,-Inf
2008/2009,17,22,2008/2009,39,28,10,18,-Inf
2008/2009,17,23,2008/2009,40,36,9,27,-Inf
2008/2009,17,24,2008/2009,41,44,2,42,-Inf
2008/2009,17,25,2008/2009,42,41,6,35,-Inf
2008/2009,17,26,2008/2009,43,35,8,27,-Inf
2008/2009,17,27,2008/2009,44,28,5,23,-Inf
2008/2009,17,28,2008/2009,45,28,1,27,-Inf
2008/2009,17,29,2008/2009,46,22,2,20,-Inf
2008/2009,17,30,2008/2009,47,26,3,23,-Inf
2008/2009,17,31,2008/2009,48,24,4,20,-Inf
2008/2009,17,32,2008/2009,49,9,3,6,-Inf
2008/2009,17,33,2008/2009,50,21,1,20,-Inf
2008/2009,17,34,2008/2009,51,10,3,7,-Inf
2008/2009,17,35,2008/2009,52,15,5,10,-Inf
2008/2009,18,1,2008/2009,19,12,71,59,-Inf
2008/2009,18,2,2008/2009,20,13,112,99,-Inf
2008/2009,18,3,2008/2009,21,13,106,93,-Inf
2008/2009,18,4,2008/2009,22,13,101,88,-Inf
2008/2009,18,5,2008/2009,23,20,170,150,-Inf
2008/2009,18,6,2008/2009,24,28,135,107,-Inf
2008/2009,18,7,2008/2009,25,45,106,61,-Inf
2008/2009,18,8,2008/2009,26,28,68,40,-Inf
2008/2009,18,9,2008/2009,27,34,48,14,-11.512925464970229
2008/2009,18,10,2008/2009,28,41,48,7,-Inf
2008/2009,18,11,2008/2009,29,36,26,10,-Inf
2008/2009,18,12,2008/2009,30,38,33,5,-Inf
2008/2009,18,13,2008/2009,31,48,29,19,-Inf
2008/2009,18,14,2008/2009,32,27,17,10,-Inf
2008/2009,18,15,2008/2009,33,23,12,11,-Inf
2008/2009,18,16,2008/2009,34,28,13,15,-Inf
2008/2009,18,17,2008/2009,35,42,17,25,-Inf
2008/2009,18,18,2008/2009,36,30,15,15,-Inf
2008/2009,18,19,2008/2009,37,18,14,4,-Inf
2008/2009,18,20,2008/2009,38,38,15,23,-Inf
2008/2009,18,21,2008/2009,39,28,10,18,-Inf
2008/2009,18,22,2008/2009,40,36,9,27,-Inf
2008/2009,18,23,2008/2009,41,44,2,42,-Inf
2008/2009,18,24,2008/2009,42,41,6,35,-Inf
2008/2009,18,25,2008/2009,43,35,8,27,-Inf
2008/2009,18,26,2008/2009,44,28,5,23,-Inf
2008/2009,18,27,2008/2009,45,28,1,27,-Inf
2008/2009,18,28,2008/2009,46,22,2,20,-Inf
2008/2009,18,29,2008/2009,47,26,3,23,-Inf
2008/2009,18,30,2008/2009,48,24,4,20,-Inf
2008/2009,18,31,2008/2009,49,9,3,6,-11.512925464970229
2008/2009,18,32,2008/2009,50,21,1,20,-Inf
2008/2009,18,33,2008/2009,51,10,3,7,-Inf
2008/2009,18,34,2008/2009,52,15,5,10,-Inf
2008/2009,19,1,2008/2009,20,13,112,99,-Inf
2008/2009,19,2,2008/2009,21,13,106,93,-Inf
2008/2009,19,3,2008/2009,22,13,101,88,-Inf
2008/2009,19,4,2008/2009,23,20,170,150,-Inf
2008/2009,19,5,2008/2009,24,28,135,107,-Inf
2008/2009,19,6,2008/2009,25,45,106,61,-Inf
2008/2009,19,7,2008/2009,26,28,68,40,-Inf
2008/2009,19,8,2008/2009,27,34,48,14,-Inf
2008/2009,19,9,2008/2009,28,41,48,7,-Inf
2008/2009,19,10,2008/2009,29,36,26,10,-Inf
2008/2009,19,11,2008/2009,30,38,33,5,-Inf
2008/2009,19,12,2008/2009,31,48,29,19,-Inf
2008/2009,19,13,2008/2009,32,27,17,10,-Inf
2008/2009,19,14,2008/2009,33,23,12,11,-Inf
2008/2009,19,15,2008/2009,34,28,13,15,-Inf
2008/2009,19,16,2008/2009,35,42,17,25,-Inf
2008/2009,19,17,2008/2009,36,30,15,15,-Inf
2008/2009,19,18,2008/2009,37,18,14,4,-Inf
2008/2009,19,19,2008/2009,38,38,15,23,-Inf
2008/2009,19,20,2008/2009,39,28,10,18,-Inf
2008/2009,19,21,2008/2009,40,36,9,27,-Inf
2008/2009,19,22,2008/2009,41,44,2,42,-Inf
2008/2009,19,23,2008/2009,42,41,6,35,-Inf
2008/2009,19,24,2008/2009,43,35,8,27,-Inf
2008/2009,19,25,2008/2009,44,28,5,23,-Inf
2008/2009,19,26,2008/2009,45,28,1,27,-Inf
2008/2009,19,27,2008/2009,46,22,2,20,-Inf
2008/2009,19,28,2008/2009,47,26,3,23,-Inf
2008/2009,19,29,2008/2009,48,24,4,20,-Inf
2008/2009,19,30,2008/2009,49,9,3,6,-Inf
2008/2009,19,31,2008/2009,50,21,1,20,-Inf
2008/2009,19,32,2008/2009,51,10,3,7,-11.512925464970229
2008/2009,19,33,2008/2009,52,15,5,10,-Inf
2008/2009,1,1,2008/2009,2,3,8,5,-Inf
2008/2009,1,2,2008/2009,3,2,13,11,-11.512925464970229
2008/2009,1,3,2008/2009,4,3,10,7,-11.512925464970229
2008/2009,1,4,2008/2009,5,2,21,19,-Inf
2008/2009,1,5,2008/2009,6,2,18,16,-Inf
2008/2009,1,6,2008/2009,7,3,21,18,-Inf
2008/2009,1,7,2008/2009,8,4,34,30,-Inf
2008/2009,1,8,2008/2009,9,3,25,22,-Inf
2008/2009,1,9,2008/2009,10,4,34,30,-Inf
2008/2009,1,10,2008/2009,11,4,33,29,-Inf
2008/2009,1,11,2008/2009,12,4,40,36,-11.512925464970229
2008/2009,1,12,2008/2009,13,7,42,35,-Inf
2008/2009,1,13,2008/2009,14,6,36,30,-Inf
2008/2009,1,14,2008/2009,15,15,72,57,-Inf
2008/2009,1,15,2008/2009,16,11,75,64,-Inf
2008/2009,1,16,2008/2009,17,9,76,67,-Inf
2008/2009,1,17,2008/2009,18,9,92,83,-Inf
2008/2009,1,18,2008/2009,19,12,71,59,-Inf
2008/2009,1,19,2008/2009,20,13,112,99,-Inf
2008/2009,1,20,2008/2009,21,13,106,93,-Inf
2008/2009,1,21,2008/2009,22,13,101,88,-Inf
2008/2009,1,22,2008/2009,23,20,170,150,-Inf
2008/2009,1,23,2008/2009,24,28,135,107,-Inf
2008/2009,1,24,2008/2009,25,45,106,61,-Inf
2008/2009,1,25,2008/2009,26,28,68,40,-Inf
2008/2009,1,26,2008/2009,27,34,48,14,-Inf
2008/2009,1,27,2008/2009,28,41,48,7,-Inf
2008/2009,1,28,2008/2009,29,36,26,10,-Inf
2008/2009,1,29,2008/2009,30,38,33,5,-Inf
2008/2009,1,30,2008/2009,31,48,29,19,-Inf
2008/2009,1,31,2008/2009,32,27,17,10,-Inf
2008/2009,1,32,2008/2009,33,23,12,11,-11.512925464970229
2008/2009,1,33,2008/2009,34,28,13,15,-Inf
2008/2009,1,34,2008/2009,35,42,17,25,-Inf
2008/2009,1,35,2008/2009,36,30,15,15,-Inf
2008/2009,1,36,2008/2009,37,18,14,4,-Inf
2008/2009,1,37,2008/2009,38,38,15,23,-Inf
2008/2009,1,38,2008/2009,39,28,10,18,-Inf
2008/2009,1,39,2008/2009,40,36,9,27,-Inf
2008/2009,1,40,2008/2009,41,44,2,42,-Inf
2008/2009,1,41,2008/2009,42,41,6,35,-Inf
2008/2009,1,42,2008/2009,43,35,8,27,-Inf
2008/2009,1,43,2008/2009,44,28,5,23,-Inf
2008/2009,1,44,2008/2009,45,28,1,27,-Inf
2008/2009,1,45,2008/2009,46,22,2,20,-Inf
2008/2009,1,46,2008/2009,47,26,3,23,-Inf
2008/2009,1,47,2008/2009,48,24,4,20,-Inf
2008/2009,1,48,2008/2009,49,9,3,6,-Inf
2008/2009,1,49,2008/2009,50,21,1,20,-Inf
2008/2009,1,50,2008/2009,51,10,3,7,-Inf
2008/2009,1,51,2008/2009,52,15,5,10,-Inf
2008/2009,20,1,2008/2009,21,13,106,93,-Inf
2008/2009,20,2,2008/2009,22,13,101,88,-Inf
2008/2009,20,3,2008/2009,23,20,170,150,-Inf
2008/2009,20,4,2008/2009,24,28,135,107,-Inf
2008/2009,20,5,2008/2009,25,45,106,61,-Inf
2008/2009,20,6,2008/2009,26,28,68,40,-Inf
2008/2009,20,7,2008/2009,27,34,48,14,-Inf
2008/2009,20,8,2008/2009,28,41,48,7,-Inf
2008/2009,20,9,2008/2009,29,36,26,10,-Inf
2008/2009,20,10,2008/2009,30,38,33,5,-Inf
2008/2009,20,11,2008/2009,31,48,29,19,-Inf
2008/2009,20,12,2008/2009,32,27,17,10,-Inf
2008/2009,20,13,2008/2009,33,23,12,11,-Inf
2008/2009,20,14,2008/2009,34,28,13,15,-Inf
2008/2009,20,15,2008/2009,35,42,17,25,-Inf
2008/2009,20,16,2008/2009,36,30,15,15,-Inf
2008/2009,20,17,2008/2009,37,18,14,4,-Inf
2008/2009,20,18,2008/2009,38,38,15,23,-Inf
2008/2009,20,19,2008/2009,39,28,10,18,-Inf
2008/2009,20,20,2008/2009,40,36,9,27,-Inf
2008/2009,20,21,2008/2009,41,44,2,42,-Inf
2008/2009,20,22,2008/2009,42,41,6,35,-Inf
2008/2009,20,23,2008/2009,43,35,8,27,-Inf
2008/2009,20,24,2008/2009,44,28,5,23,-Inf
2008/2009,20,25,2008/2009,45,28,1,27,-Inf
2008/2009,20,26,2008/2009,46,22,2,20,-Inf
2008/2009,20,27,2008/2009,47,26,3,23,-Inf
2008/2009,20,28,2008/2009,48,24,4,20,-Inf
2008/2009,20,29,2008/2009,49,9,3,6,-Inf
2008/2009,20,30,2008/2009,50,21,1,20,-Inf
2008/2009,20,31,2008/2009,51,10,3,7,-Inf
2008/2009,20,32,2008/2009,52,15,5,10,-Inf
2008/2009,21,1,2008/2009,22,13,101,88,-Inf
2008/2009,21,2,2008/2009,23,20,170,150,-Inf
2008/2009,21,3,2008/2009,24,28,135,107,-Inf
2008/2009,21,4,2008/2009,25,45,106,61,-Inf
2008/2009,21,5,2008/2009,26,28,68,40,-Inf
2008/2009,21,6,2008/2009,27,34,48,14,-Inf
2008/2009,21,7,2008/2009,28,41,48,7,-Inf
2008/2009,21,8,2008/2009,29,36,26,10,-Inf
2008/2009,21,9,2008/2009,30,38,33,5,-Inf
2008/2009,21,10,2008/2009,31,48,29,19,-Inf
2008/2009,21,11,2008/2009,32,27,17,10,-Inf
2008/2009,21,12,2008/2009,33,23,12,11,-Inf
2008/2009,21,13,2008/2009,34,28,13,15,-Inf
2008/2009,21,14,2008/2009,35,42,17,25,-Inf
2008/2009,21,15,2008/2009,36,30,15,15,-Inf
2008/2009,21,16,2008/2009,37,18,14,4,-Inf
2008/2009,21,17,2008/2009,38,38,15,23,-Inf
2008/2009,21,18,2008/2009,39,28,10,18,-Inf
2008/2009,21,19,2008/2009,40,36,9,27,-Inf
2008/2009,21,20,2008/2009,41,44,2,42,-Inf
2008/2009,21,21,2008/2009,42,41,6,35,-Inf
2008/2009,21,22,2008/2009,43,35,8,27,-Inf
2008/2009,21,23,2008/2009,44,28,5,23,-Inf
2008/2009,21,24,2008/2009,45,28,1,27,-Inf
2008/2009,21,25,2008/2009,46,22,2,20,-Inf
2008/2009,21,26,2008/2009,47,26,3,23,-Inf
2008/2009,21,27,2008/2009,48,24,4,20,-Inf
2008/2009,21,28,2008/2009,49,9,3,6,-Inf
2008/2009,21,29,2008/2009,50,21,1,20,-Inf
2008/2009,21,30,2008/2009,51,10,3,7,-Inf
2008/2009,21,31,2008/2009,52,15,5,10,-Inf
2008/2009,22,1,2008/2009,23,20,170,150,-Inf
2008/2009,22,2,2008/2009,24,28,135,107,-Inf
2008/2009,22,3,2008/2009,25,45,106,61,-Inf
2008/2009,22,4,2008/2009,26,28,68,40,-Inf
2008/2009,22,5,2008/2009,27,34,48,14,-Inf
2008/2009,22,6,2008/2009,28,41,48,7,-Inf
2008/2009,22,7,2008/2009,29,36,26,10,-Inf
2008/2009,22,8,2008/2009,30,38,33,5,-Inf
2008/2009,22,9,2008/2009,31,48,29,19,-Inf
2008/2009,22,10,2008/2009,32,27,17,10,-Inf
2008/2009,22,11,2008/2009,33,23,12,11,-Inf
2008/2009,22,12,2008/2009,34,28,13,15,-Inf
2008/2009,22,13,2008/2009,35,42,17,25,-Inf
2008/2009,22,14,2008/2009,36,30,15,15,-Inf
2008/2009,22,15,2008/2009,37,18,14,4,-Inf
2008/2009,22,16,2008/2009,38,38,15,23,-Inf
2008/2009,22,17,2008/2009,39,28,10,18,-Inf
2008/2009,22,18,2008/2009,40,36,9,27,-Inf
2008/2009,22,19,2008/2009,41,44,2,42,-Inf
2008/2009,22,20,2008/2009,42,41,6,35,-Inf
2008/2009,22,21,2008/2009,43,35,8,27,-Inf
2008/2009,22,22,2008/2009,44,28,5,23,-Inf
2008/2009,22,23,2008/2009,45,28,1,27,-Inf
2008/2009,22,24,2008/2009,46,22,2,20,-Inf
2008/2009,22,25,2008/2009,47,26,3,23,-Inf
2008/2009,22,26,2008/2009,48,24,4,20,-Inf
2008/2009,22,27,2008/2009,49,9,3,6,-Inf
2008/2009,22,28,2008/2009,50,21,1,20,-Inf
2008/2009,22,29,2008/2009,51,10,3,7,-Inf
2008/2009,22,30,2008/2009,52,15,5,10,-Inf
2008/2009,23,1,2008/2009,24,28,135,107,-Inf
2008/2009,23,2,2008/2009,25,45,106,61,-Inf
2008/2009,23,3,2008/2009,26,28,68,40,-Inf
2008/2009,23,4,2008/2009,27,34,48,14,-Inf
2008/2009,23,5,2008/2009,28,41,48,7,-Inf
2008/2009,23,6,2008/2009,29,36,26,10,-Inf
2008/2009,23,7,2008/2009,30,38,33,5,-Inf
2008/2009,23,8,2008/2009,31,48,29,19,-Inf
2008/2009,23,9,2008/2009,32,27,17,10,-Inf
2008/2009,23,10,2008/2009,33,23,12,11,-Inf
2008/2009,23,11,2008/2009,34,28,13,15,-Inf
2008/2009,23,12,2008/2009,35,42,17,25,-Inf
2008/2009,23,13,2008/2009,36,30,15,15,-Inf
2008/2009,23,14,2008/2009,37,18,14,4,-Inf
2008/2009,23,15,2008/2009,38,38,15,23,-Inf
2008/2009,23,16,2008/2009,39,28,10,18,-Inf
2008/2009,23,17,2008/2009,40,36,9,27,-Inf
2008/2009,23,18,2008/2009,41,44,2,42,-Inf
2008/2009,23,19,2008/2009,42,41,6,35,-Inf
2008/2009,23,20,2008/2009,43,35,8,27,-Inf
2008/2009,23,21,2008/2009,44,28,5,23,-Inf
2008/2009,23,22,2008/2009,45,28,1,27,-Inf
2008/2009,23,23,2008/2009,46,22,2,20,-Inf
2008/2009,23,24,2008/2009,47,26,3,23,-Inf
2008/2009,23,25,2008/2009,48,24,4,20,-Inf
2008/2009,23,26,2008/2009,49,9,3,6,-Inf
2008/2009,23,27,2008/2009,50,21,1,20,-Inf
2008/2009,23,28,2008/2009,51,10,3,7,-Inf
2008/2009,23,29,2008/2009,52,15,5,10,-Inf
2008/2009,24,1,2008/2009,25,45,106,61,-Inf
2008/2009,24,2,2008/2009,26,28,68,40,-Inf
2008/2009,24,3,2008/2009,27,34,48,14,-11.512925464970229
2008/2009,24,4,2008/2009,28,41,48,7,-Inf
2008/2009,24,5,2008/2009,29,36,26,10,-Inf
2008/2009,24,6,2008/2009,30,38,33,5,-Inf
2008/2009,24,7,2008/2009,31,48,29,19,-Inf
2008/2009,24,8,2008/2009,32,27,17,10,-Inf
2008/2009,24,9,2008/2009,33,23,12,11,-Inf
2008/2009,24,10,2008/2009,34,28,13,15,-Inf
2008/2009,24,11,2008/2009,35,42,17,25,-Inf
2008/2009,24,12,2008/2009,36,30,15,15,-Inf
2008/2009,24,13,2008/2009,37,18,14,4,-Inf
2008/2009,24,14,2008/2009,38,38,15,23,-Inf
2008/2009,24,15,2008/2009,39,28,10,18,-Inf
2008/2009,24,16,2008/2009,40,36,9,27,-Inf
2008/2009,24,17,2008/2009,41,44,2,42,-Inf
2008/2009,24,18,2008/2009,42,41,6,35,-Inf
2008/2009,24,19,2008/2009,43,35,8,27,-Inf
2008/2009,24,20,2008/2009,44,28,5,23,-Inf
2008/2009,24,21,2008/2009,45,28,1,27,-Inf
2008/2009,24,22,2008/2009,46,22,2,20,-Inf
2008/2009,24,23,2008/2009,47,26,3,23,-Inf
2008/2009,24,24,2008/2009,48,24,4,20,-Inf
2008/2009,24,25,2008/2009,49,9,3,6,-Inf
2008/2009,24,26,2008/2009,50,21,1,20,-Inf
2008/2009,24,27,2008/2009,51,10,3,7,-Inf
2008/2009,24,28,2008/2009,52,15,5,10,-11.512925464970229
2008/2009,25,1,2008/2009,26,28,68,40,-Inf
2008/2009,25,2,2008/2009,27,34,48,14,-Inf
2008/2009,25,3,2008/2009,28,41,48,7,-Inf
2008/2009,25,4,2008/2009,29,36,26,10,-Inf
2008/2009,25,5,2008/2009,30,38,33,5,-Inf
2008/2009,25,6,2008/2009,31,48,29,19,-Inf
2008/2009,25,7,2008/2009,32,27,17,10,-Inf
2008/2009,25,8,2008/2009,33,23,12,11,-Inf
2008/2009,25,9,2008/2009,34,28,13,15,-Inf
2008/2009,25,10,2008/2009,35,42,17,25,-Inf
2008/2009,25,11,2008/2009,36,30,15,15,-Inf
2008/2009,25,12,2008/2009,37,18,14,4,-Inf
2008/2009,25,13,2008/2009,38,38,15,23,-Inf
2008/2009,25,14,2008/2009,39,28,10,18,-Inf
2008/2009,25,15,2008/2009,40,36,9,27,-Inf
2008/2009,25,16,2008/2009,41,44,2,42,-Inf
2008/2009,25,17,2008/2009,42,41,6,35,-Inf
2008/2009,25,18,2008/2009,43,35,8,27,-Inf
2008/2009,25,19,2008/2009,44,28,5,23,-Inf
2008/2009,25,20,2008/2009,45,28,1,27,-Inf
2008/2009,25,21,2008/2009,46,22,2,20,-Inf
2008/2009,25,22,2008/2009,47,26,3,23,-Inf
2008/2009,25,23,2008/2009,48,24,4,20,-Inf
2008/2009,25,24,2008/2009,49,9,3,6,-Inf
2008/2009,25,25,2008/2009,50,21,1,20,-Inf
2008/2009,25,26,2008/2009,51,10,3,7,-Inf
2008/2009,25,27,2008/2009,52,15,5,10,-Inf
2008/2009,26,1,2008/2009,27,34,48,14,-Inf
2008/2009,26,2,2008/2009,28,41,48,7,-10.819778284410283
2008/2009,26,3,2008/2009,29,36,26,10,-Inf
2008/2009,26,4,2008/2009,30,38,33,5,-Inf
2008/2009,26,5,2008/2009,31,48,29,19,-Inf
2008/2009,26,6,2008/2009,32,27,17,10,-Inf
2008/2009,26,7,2008/2009,33,23,12,11,-Inf
2008/2009,26,8,2008/2009,34,28,13,15,-Inf
2008/2009,26,9,2008/2009,35,42,17,25,-Inf
2008/2009,26,10,2008/2009,36,30,15,15,-Inf
2008/2009,26,11,2008/2009,37,18,14,4,-Inf
2008/2009,26,12,2008/2009,38,38,15,23,-Inf
2008/2009,26,13,2008/2009,39,28,10,18,-Inf
2008/2009,26,14,2008/2009,40,36,9,27,-Inf
2008/2009,26,15,2008/2009,41,44,2,42,-Inf
2008/2009,26,16,2008/2009,42,41,6,35,-Inf
2008/2009,26,17,2008/2009,43,35,8,27,-Inf
2008/2009,26,18,2008/2009,44,28,5,23,-Inf
2008/2009,26,19,2008/2009,45,28,1,27,-Inf
2008/2009,26,20,2008/2009,46,22,2,20,-Inf
2008/2009,26,21,2008/2009,47,26,3,23,-Inf
2008/2009,26,22,2008/2009,48,24,4,20,-Inf
2008/2009,26,23,2008/2009,49,9,3,6,-Inf
2008/2009,26,24,2008/2009,50,21,1,20,-Inf
2008/2009,26,25,2008/2009,51,10,3,7,-Inf
2008/2009,26,26,2008/2009,52,15,5,10,-Inf
2008/2009,27,1,2008/2009,28,41,48,7,-Inf
2008/2009,27,2,2008/2009,29,36,26,10,-Inf
2008/2009,27,3,2008/2009,30,38,33,5,-Inf
2008/2009,27,4,2008/2009,31,48,29,19,-Inf
2008/2009,27,5,2008/2009,32,27,17,10,-Inf
2008/2009,27,6,2008/2009,33,23,12,11,-Inf
2008/2009,27,7,2008/2009,34,28,13,15,-Inf
2008/2009,27,8,2008/2009,35,42,17,25,-Inf
2008/2009,27,9,2008/2009,36,30,15,15,-Inf
2008/2009,27,10,2008/2009,37,18,14,4,-Inf
2008/2009,27,11,2008/2009,38,38,15,23,-Inf
2008/2009,27,12,2008/2009,39,28,10,18,-Inf
2008/2009,27,13,2008/2009,40,36,9,27,-Inf
2008/2009,27,14,2008/2009,41,44,2,42,-Inf
2008/2009,27,15,2008/2009,42,41,6,35,-Inf
2008/2009,27,16,2008/2009,43,35,8,27,-Inf
2008/2009,27,17,2008/2009,44,28,5,23,-Inf
2008/2009,27,18,2008/2009,45,28,1,27,-Inf
2008/2009,27,19,2008/2009,46,22,2,20,-Inf
2008/2009,27,20,2008/2009,47,26,3,23,-Inf
2008/2009,27,21,2008/2009,48,24,4,20,-Inf
2008/2009,27,22,2008/2009,49,9,3,6,-Inf
2008/2009,27,23,2008/2009,50,21,1,20,-Inf
2008/2009,27,24,2008/2009,51,10,3,7,-Inf
2008/2009,27,25,2008/2009,52,15,5,10,-Inf
2008/2009,28,1,2008/2009,29,36,26,10,-Inf
2008/2009,28,2,2008/2009,30,38,33,5,-Inf
2008/2009,28,3,2008/2009,31,48,29,19,-Inf
2008/2009,28,4,2008/2009,32,27,17,10,-11.512925464970229
2008/2009,28,5,2008/2009,33,23,12,11,-Inf
2008/2009,28,6,2008/2009,34,28,13,15,-Inf
2008/2009,28,7,2008/2009,35,42,17,25,-Inf
2008/2009,28,8,2008/2009,36,30,15,15,-Inf
2008/2009,28,9,2008/2009,37,18,14,4,-Inf
2008/2009,28,10,2008/2009,38,38,15,23,-Inf
2008/2009,28,11,2008/2009,39,28,10,18,-Inf
2008/2009,28,12,2008/2009,40,36,9,27,-Inf
2008/2009,28,13,2008/2009,41,44,2,42,-Inf
2008/2009,28,14,2008/2009,42,41,6,35,-Inf
2008/2009,28,15,2008/2009,43,35,8,27,-Inf
2008/2009,28,16,2008/2009,44,28,5,23,-Inf
2008/2009,28,17,2008/2009,45,28,1,27,-Inf
2008/2009,28,18,2008/2009,46,22,2,20,-Inf
2008/2009,28,19,2008/2009,47,26,3,23,-Inf
2008/2009,28,20,2008/2009,48,24,4,20,-Inf
2008/2009,28,21,2008/2009,49,9,3,6,-Inf
2008/2009,28,22,2008/2009,50,21,1,20,-Inf
2008/2009,28,23,2008/2009,51,10,3,7,-Inf
2008/2009,28,24,2008/2009,52,15,5,10,-Inf
2008/2009,29,1,2008/2009,30,38,33,5,-Inf
2008/2009,29,2,2008/2009,31,48,29,19,-Inf
2008/2009,29,3,2008/2009,32,27,17,10,-Inf
2008/2009,29,4,2008/2009,33,23,12,11,-Inf
2008/2009,29,5,2008/2009,34,28,13,15,-Inf
2008/2009,29,6,2008/2009,35,42,17,25,-Inf
2008/2009,29,7,2008/2009,36,30,15,15,-Inf
2008/2009,29,8,2008/2009,37,18,14,4,-Inf
2008/2009,29,9,2008/2009,38,38,15,23,-Inf
2008/2009,29,10,2008/2009,39,28,10,18,-Inf
2008/2009,29,11,2008/2009,40,36,9,27,-Inf
2008/2009,29,12,2008/2009,41,44,2,42,-Inf
2008/2009,29,13,2008/2009,42,41,6,35,-Inf
2008/2009,29,14,2008/2009,43,35,8,27,-Inf
2008/2009,29,15,2008/2009,44,28,5,23,-Inf
2008/2009,29,16,2008/2009,45,28,1,27,-Inf
2008/2009,29,17,2008/2009,46,22,2,20,-Inf
2008/2009,29,18,2008/2009,47,26,3,23,-Inf
2008/2009,29,19,2008/2009,48,24,4,20,-Inf
2008/2009,29,20,2008/2009,49,9,3,6,-Inf
2008/2009,29,21,2008/2009,50,21,1,20,-Inf
2008/2009,29,22,2008/2009,51,10,3,7,-Inf
2008/2009,29,23,2008/2009,52,15,5,10,-Inf
2008/2009,2,1,2008/2009,3,2,13,11,-11.512925464970229
2008/2009,2,2,2008/2009,4,3,10,7,-11.512925464970229
2008/2009,2,3,2008/2009,5,2,21,19,-Inf
2008/2009,2,4,2008/2009,6,2,18,16,-Inf
2008/2009,2,5,2008/2009,7,3,21,18,-Inf
2008/2009,2,6,2008/2009,8,4,34,30,-Inf
2008/2009,2,7,2008/2009,9,3,25,22,-Inf
2008/2009,2,8,2008/2009,10,4,34,30,-Inf
2008/2009,2,9,2008/2009,11,4,33,29,-Inf
2008/2009,2,10,2008/2009,12,4,40,36,-Inf
2008/2009,2,11,2008/2009,13,7,42,35,-Inf
2008/2009,2,12,2008/2009,14,6,36,30,-Inf
2008/2009,2,13,2008/2009,15,15,72,57,-Inf
2008/2009,2,14,2008/2009,16,11,75,64,-Inf
2008/2009,2,15,2008/2009,17,9,76,67,-Inf
2008/2009,2,16,2008/2009,18,9,92,83,-Inf
2008/2009,2,17,2008/2009,19,12,71,59,-Inf
2008/2009,2,18,2008/2009,20,13,112,99,-Inf
2008/2009,2,19,2008/2009,21,13,106,93,-Inf
2008/2009,2,20,2008/2009,22,13,101,88,-Inf
2008/2009,2,21,2008/2009,23,20,170,150,-Inf
2008/2009,2,22,2008/2009,24,28,135,107,-Inf
2008/2009,2,23,2008/2009,25,45,106,61,-Inf
2008/2009,2,24,2008/2009,26,28,68,40,-Inf
2008/2009,2,25,2008/2009,27,34,48,14,-11.512925464970229
2008/2009,2,26,2008/2009,28,41,48,7,-11.512925464970229
2008/2009,2,27,2008/2009,29,36,26,10,-Inf
2008/2009,2,28,2008/2009,30,38,33,5,-11.512925464970229
2008/2009,2,29,2008/2009,31,48,29,19,-Inf
2008/2009,2,30,2008/2009,32,27,17,10,-Inf
2008/2009,2,31,2008/2009,33,23,12,11,-Inf
2008/2009,2,32,2008/2009,34,28,13,15,-Inf
2008/2009,2,33,2008/2009,35,42,17,25,-Inf
2008/2009,2,34,2008/2009,36,30,15,15,-Inf
2008/2009,2,35,2008/2009,37,18,14,4,-Inf
2008/2009,2,36,2008/2009,38,38,15,23,-Inf
2008/2009,2,37,2008/2009,39,28,10,18,-Inf
2008/2009,2,38,2008/2009,40,36,9,27,-Inf
2008/2009,2,39,2008/2009,41,44,2,42,-Inf
2008/2009,2,40,2008/2009,42,41,6,35,-Inf
2008/2009,2,41,2008/2009,43,35,8,27,-Inf
2008/2009,2,42,2008/2009,44,28,5,23,-Inf
2008/2009,2,43,2008/2009,45,28,1,27,-Inf
2008/2009,2,44,2008/2009,46,22,2,20,-Inf
2008/2009,2,45,2008/2009,47,26,3,23,-Inf
2008/2009,2,46,2008/2009,48,24,4,20,-Inf
2008/2009,2,47,2008/2009,49,9,3,6,-Inf
2008/2009,2,48,2008/2009,50,21,1,20,-Inf
2008/2009,2,49,2008/2009,51,10,3,7,-Inf
2008/2009,2,50,2008/2009,52,15,5,10,-Inf
2008/2009,30,1,2008/2009,31,48,29,19,-Inf
2008/2009,30,2,2008/2009,32,27,17,10,-Inf
2008/2009,30,3,2008/2009,33,23,12,11,-Inf
2008/2009,30,4,2008/2009,34,28,13,15,-Inf
2008/2009,30,5,2008/2009,35,42,17,25,-Inf
2008/2009,30,6,2008/2009,36,30,15,15,-Inf
2008/2009,30,7,2008/2009,37,18,14,4,-10.819778284410283
2008/2009,30,8,2008/2009,38,38,15,23,-Inf
2008/2009,30,9,2008/2009,39,28,10,18,-Inf
2008/2009,30,10,2008/2009,40,36,9,27,-Inf
2008/2009,30,11,2008/2009,41,44,2,42,-Inf
2008/2009,30,12,2008/2009,42,41,6,35,-Inf
2008/2009,30,13,2008/2009,43,35,8,27,-Inf
2008/2009,30,14,2008/2009,44,28,5,23,-Inf
2008/2009,30,15,2008/2009,45,28,1,27,-Inf
2008/2009,30,16,2008/2009,46,22,2,20,-Inf
2008/2009,30,17,2008/2009,47,26,3,23,-Inf
2008/2009,30,18,2008/2009,48,24,4,20,-Inf
2008/2009,30,19,2008/2009,49,9,3,6,-Inf
2008/2009,30,20,2008/2009,50,21,1,20,-Inf
2008/2009,30,21,2008/2009,51,10,3,7,-Inf
2008/2009,30,22,2008/2009,52,15,5,10,-10.819778284410283
2008/2009,31,1,2008/2009,32,27,17,10,-Inf
2008/2009,31,2,2008/2009,33,23,12,11,-Inf
2008/2009,31,3,2008/2009,34,28,13,15,-11.512925464970229
2008/2009,31,4,2008/2009,35,42,17,25,-Inf
2008/2009,31,5,2008/2009,36,30,15,15,-Inf
2008/2009,31,6,2008/2009,37,18,14,4,-11.512925464970229
2008/2009,31,7,2008/2009,38,38,15,23,-Inf
2008/2009,31,8,2008/2009,39,28,10,18,-Inf
2008/2009,31,9,2008/2009,40,36,9,27,-Inf
2008/2009,31,10,2008/2009,41,44,2,42,-Inf
2008/2009,31,11,2008/2009,42,41,6,35,-Inf
2008/2009,31,12,2008/2009,43,35,8,27,-Inf
2008/2009,31,13,2008/2009,44,28,5,23,-Inf
2008/2009,31,14,2008/2009,45,28,1,27,-Inf
2008/2009,31,15,2008/2009,46,22,2,20,-Inf
2008/2009,31,16,2008/2009,47,26,3,23,-Inf
2008/2009,31,17,2008/2009,48,24,4,20,-Inf
2008/2009,31,18,2008/2009,49,9,3,6,-Inf
2008/2009,31,19,2008/2009,50,21,1,20,-Inf
2008/2009,31,20,2008/2009,51,10,3,7,-Inf
2008/2009,31,21,2008/2009,52,15,5,10,-Inf
2008/2009,32,1,2008/2009,33,23,12,11,-11.512925464970229
2008/2009,32,2,2008/2009,34,28,13,15,-Inf
2008/2009,32,3,2008/2009,35,42,17,25,-Inf
2008/2009,32,4,2008/2009,36,30,15,15,-Inf
2008/2009,32,5,2008/2009,37,18,14,4,-11.512925464970229
2008/2009,32,6,2008/2009,38,38,15,23,-Inf
2008/2009,32,7,2008/2009,39,28,10,18,-Inf
2008/2009,32,8,2008/2009,40,36,9,27,-Inf
2008/2009,32,9,2008/2009,41,44,2,42,-11.512925464970229
2008/2009,32,10,2008/2009,42,41,6,35,-Inf
2008/2009,32,11,2008/2009,43,35,8,27,-Inf
2008/2009,32,12,2008/2009,44,28,5,23,-Inf
2008/2009,32,13,2008/2009,45,28,1,27,-Inf
2008/2009,32,14,2008/2009,46,22,2,20,-Inf
2008/2009,32,15,2008/2009,47,26,3,23,-Inf
2008/2009,32,16,2008/2009,48,24,4,20,-Inf
2008/2009,32,17,2008/2009,49,9,3,6,-11.512925464970229
2008/2009,32,18,2008/2009,50,21,1,20,-Inf
2008/2009,32,19,2008/2009,51,10,3,7,-Inf
2008/2009,32,20,2008/2009,52,15,5,10,-Inf
2008/2009,33,1,2008/2009,34,28,13,15,-Inf
2008/2009,33,2,2008/2009,35,42,17,25,-Inf
2008/2009,33,3,2008/2009,36,30,15,15,-Inf
2008/2009,33,4,2008/2009,37,18,14,4,-11.512925464970229
2008/2009,33,5,2008/2009,38,38,15,23,-Inf
2008/2009,33,6,2008/2009,39,28,10,18,-11.512925464970229
2008/2009,33,7,2008/2009,40,36,9,27,-Inf
2008/2009,33,8,2008/2009,41,44,2,42,-Inf
2008/2009,33,9,2008/2009,42,41,6,35,-Inf
2008/2009,33,10,2008/2009,43,35,8,27,-Inf
2008/2009,33,11,2008/2009,44,28,5,23,-Inf
2008/2009,33,12,2008/2009,45,28,1,27,-Inf
2008/2009,33,13,2008/2009,46,22,2,20,-Inf
2008/2009,33,14,2008/2009,47,26,3,23,-Inf
2008/2009,33,15,2008/2009,48,24,4,20,-Inf
2008/2009,33,16,2008/2009,49,9,3,6,-Inf
2008/2009,33,17,2008/2009,50,21,1,20,-Inf
2008/2009,33,18,2008/2009,51,10,3,7,-Inf
2008/2009,33,19,2008/2009,52,15,5,10,-Inf
2008/2009,34,1,2008/2009,35,42,17,25,-Inf
2008/2009,34,2,2008/2009,36,30,15,15,-Inf
2008/2009,34,3,2008/2009,37,18,14,4,-11.512925464970229
2008/2009,34,4,2008/2009,38,38,15,23,-Inf
2008/2009,34,5,2008/2009,39,28,10,18,-Inf
2008/2009,34,6,2008/2009,40,36,9,27,-Inf
2008/2009,34,7,2008/2009,41,44,2,42,-Inf
2008/2009,34,8,2008/2009,42,41,6,35,-Inf
2008/2009,34,9,2008/2009,43,35,8,27,-11.512925464970229
2008/2009,34,10,2008/2009,44,28,5,23,-Inf
2008/2009,34,11,2008/2009,45,28,1,27,-Inf
2008/2009,34,12,2008/2009,46,22,2,20,-Inf
2008/2009,34,13,2008/2009,47,26,3,23,-10.819778284410283
2008/2009,34,14,2008/2009,48,24,4,20,-Inf
2008/2009,34,15,2008/2009,49,9,3,6,-11.512925464970229
2008/2009,34,16,2008/2009,50,21,1,20,-Inf
2008/2009,34,17,2008/2009,51,10,3,7,-Inf
2008/2009,34,18,2008/2009,52,15,5,10,-Inf
2008/2009,35,1,2008/2009,36,30,15,15,-Inf
2008/2009,35,2,2008/2009,37,18,14,4,-Inf
2008/2009,35,3,2008/2009,38,38,15,23,-Inf
2008/2009,35,4,2008/2009,39,28,10,18,-Inf
2008/2009,35,5,2008/2009,40,36,9,27,-Inf
2008/2009,35,6,2008/2009,41,44,2,42,-Inf
2008/2009,35,7,2008/2009,42,41,6,35,-Inf
2008/2009,35,8,2008/2009,43,35,8,27,-Inf
2008/2009,35,9,2008/2009,44,28,5,23,-Inf
2008/2009,35,10,2008/2009,45,28,1,27,-11.512925464970229
2008/2009,35,11,2008/2009,46,22,2,20,-Inf
2008/2009,35,12,2008/2009,47,26,3,23,-Inf
2008/2009,35,13,2008/2009,48,24,4,20,-Inf
2008/2009,35,14,2008/2009,49,9,3,6,-Inf
2008/2009,35,15,2008/2009,50,21,1,20,-Inf
2008/2009,35,16,2008/2009,51,10,3,7,-Inf
2008/2009,35,17,2008/2009,52,15,5,10,-11.512925464970229
2008/2009,36,1,2008/2009,37,18,14,4,-Inf
2008/2009,36,2,2008/2009,38,38,15,23,-Inf
2008/2009,36,3,2008/2009,39,28,10,18,-Inf
2008/2009,36,4,2008/2009,40,36,9,27,-Inf
2008/2009,36,5,2008/2009,41,44,2,42,-Inf
2008/2009,36,6,2008/2009,42,41,6,35,-Inf
2008/2009,36,7,2008/2009,43,35,8,27,-Inf
2008/2009,36,8,2008/2009,44,28,5,23,-Inf
2008/2009,36,9,2008/2009,45,28,1,27,-Inf
2008/2009,36,10,2008/2009,46,22,2,20,-Inf
2008/2009,36,11,2008/2009,47,26,3,23,-Inf
2008/2009,36,12,2008/2009,48,24,4,20,-Inf
2008/2009,36,13,2008/2009,49,9,3,6,-Inf
2008/2009,36,14,2008/2009,50,21,1,20,-Inf
2008/2009,36,15,2008/2009,51,10,3,7,-11.512925464970229
2008/2009,36,16,2008/2009,52,15,5,10,-10.819778284410283
2008/2009,37,1,2008/2009,38,38,15,23,-Inf
2008/2009,37,2,2008/2009,39,28,10,18,-Inf
2008/2009,37,3,2008/2009,40,36,9,27,-Inf
2008/2009,37,4,2008/2009,41,44,2,42,-Inf
2008/2009,37,5,2008/2009,42,41,6,35,-Inf
2008/2009,37,6,2008/2009,43,35,8,27,-Inf
2008/2009,37,7,2008/2009,44,28,5,23,-Inf
2008/2009,37,8,2008/2009,45,28,1,27,-Inf
2008/2009,37,9,2008/2009,46,22,2,20,-Inf
2008/2009,37,10,2008/2009,47,26,3,23,-Inf
2008/2009,37,11,2008/2009,48,24,4,20,-Inf
2008/2009,37,12,2008/2009,49,9,3,6,-Inf
2008/2009,37,13,2008/2009,50,21,1,20,-10.819778284410283
2008/2009,37,14,2008/2009,51,10,3,7,-Inf
2008/2009,37,15,2008/2009,52,15,5,10,-Inf
2008/2009,38,1,2008/2009,39,28,10,18,-Inf
2008/2009,38,2,2008/2009,40,36,9,27,-Inf
2008/2009,38,3,2008/2009,41,44,2,42,-Inf
2008/2009,38,4,2008/2009,42,41,6,35,-Inf
2008/2009,38,5,2008/2009,43,35,8,27,-Inf
2008/2009,38,6,2008/2009,44,28,5,23,-Inf
2008/2009,38,7,2008/2009,45,28,1,27,-Inf
2008/2009,38,8,2008/2009,46,22,2,20,-Inf
2008/2009,38,9,2008/2009,47,26,3,23,-11.512925464970229
2008/2009,38,10,2008/2009,48,24,4,20,-11.512925464970229
2008/2009,38,11,2008/2009,49,9,3,6,-Inf
2008/2009,38,12,2008/2009,50,21,1,20,-Inf
2008/2009,38,13,2008/2009,51,10,3,7,-10.819778284410283
2008/2009,38,14,2008/2009,52,15,5,10,-Inf
2008/2009,39,1,2008/2009,40,36,9,27,-Inf
2008/2009,39,2,2008/2009,41,44,2,42,-Inf
2008/2009,39,3,2008/2009,42,41,6,35,-Inf
2008/2009,39,4,2008/2009,43,35,8,27,-Inf
2008/2009,39,5,2008/2009,44,28,5,23,-Inf
2008/2009,39,6,2008/2009,45,28,1,27,-Inf
2008/2009,39,7,2008/2009,46,22,2,20,-Inf
2008/2009,39,8,2008/2009,47,26,3,23,-Inf
2008/2009,39,9,2008/2009,48,24,4,20,-Inf
2008/2009,39,10,2008/2009,49,9,3,6,-Inf
2008/2009,39,11,2008/2009,50,21,1,20,-Inf
2008/2009,39,12,2008/2009,51,10,3,7,-Inf
2008/2009,39,13,2008/2009,52,15,5,10,-11.512925464970229
2008/2009,3,1,2008/2009,4,3,10,7,-Inf
2008/2009,3,2,2008/2009,5,2,21,19,-Inf
2008/2009,3,3,2008/2009,6,2,18,16,-Inf
2008/2009,3,4,2008/2009,7,3,21,18,-Inf
2008/2009,3,5,2008/2009,8,4,34,30,-Inf
2008/2009,3,6,2008/2009,9,3,25,22,-Inf
2008/2009,3,7,2008/2009,10,4,34,30,-Inf
2008/2009,3,8,2008/2009,11,4,33,29,-Inf
2008/2009,3,9,2008/2009,12,4,40,36,-Inf
2008/2009,3,10,2008/2009,13,7,42,35,-Inf
2008/2009,3,11,2008/2009,14,6,36,30,-Inf
2008/2009,3,12,2008/2009,15,15,72,57,-Inf
2008/2009,3,13,2008/2009,16,11,75,64,-Inf
2008/2009,3,14,2008/2009,17,9,76,67,-Inf
2008/2009,3,15,2008/2009,18,9,92,83,-Inf
2008/2009,3,16,2008/2009,19,12,71,59,-11.512925464970229
2008/2009,3,17,2008/2009,20,13,112,99,-Inf
2008/2009,3,18,2008/2009,21,13,106,93,-Inf
2008/2009,3,19,2008/2009,22,13,101,88,-Inf
2008/2009,3,20,2008/2009,23,20,170,150,-Inf
2008/2009,3,21,2008/2009,24,28,135,107,-Inf
2008/2009,3,22,2008/2009,25,45,106,61,-Inf
2008/2009,3,23,2008/2009,26,28,68,40,-Inf
2008/2009,3,24,2008/2009,27,34,48,14,-Inf
2008/2009,3,25,2008/2009,28,41,48,7,-Inf
2008/2009,3,26,2008/2009,29,36,26,10,-Inf
2008/2009,3,27,2008/2009,30,38,33,5,-Inf
2008/2009,3,28,2008/2009,31,48,29,19,-Inf
2008/2009,3,29,2008/2009,32,27,17,10,-Inf
2008/2009,3,30,2008/2009,33,23,12,11,-Inf
2008/2009,3,31,2008/2009,34,28,13,15,-Inf
2008/2009,3,32,2008/2009,35,42,17,25,-Inf
2008/2009,3,33,2008/2009,36,30,15,15,-Inf
2008/2009,3,34,2008/2009,37,18,14,4,-Inf
2008/2009,3,35,2008/2009,38,38,15,23,-Inf
2008/2009,3,36,2008/2009,39,28,10,18,-Inf
2008/2009,3,37,2008/2009,40,36,9,27,-Inf
2008/2009,3,38,2008/2009,41,44,2,42,-Inf
2008/2009,3,39,2008/2009,42,41,6,35,-Inf
2008/2009,3,40,2008/2009,43,35,8,27,-Inf
2008/2009,3,41,2008/2009,44,28,5,23,-Inf
2008/2009,3,42,2008/2009,45,28,1,27,-Inf
2008/2009,3,43,2008/2009,46,22,2,20,-Inf
2008/2009,3,44,2008/2009,47,26,3,23,-Inf
2008/2009,3,45,2008/2009,48,24,4,20,-11.512925464970229
2008/2009,3,46,2008/2009,49,9,3,6,-11.512925464970229
2008/2009,3,47,2008/2009,50,21,1,20,-Inf
2008/2009,3,48,2008/2009,51,10,3,7,-Inf
2008/2009,3,49,2008/2009,52,15,5,10,-Inf
2008/2009,40,1,2008/2009,41,44,2,42,-Inf
2008/2009,40,2,2008/2009,42,41,6,35,-Inf
2008/2009,40,3,2008/2009,43,35,8,27,-Inf
2008/2009,40,4,2008/2009,44,28,5,23,-11.512925464970229
2008/2009,40,5,2008/2009,45,28,1,27,-Inf
2008/2009,40,6,2008/2009,46,22,2,20,-Inf
2008/2009,40,7,2008/2009,47,26,3,23,-Inf
2008/2009,40,8,2008/2009,48,24,4,20,-Inf
2008/2009,40,9,2008/2009,49,9,3,6,-11.512925464970229
2008/2009,40,10,2008/2009,50,21,1,20,-Inf
2008/2009,40,11,2008/2009,51,10,3,7,-Inf
2008/2009,40,12,2008/2009,52,15,5,10,-Inf
2008/2009,41,1,2008/2009,42,41,6,35,-Inf
2008/2009,41,2,2008/2009,43,35,8,27,-Inf
2008/2009,41,3,2008/2009,44,28,5,23,-Inf
2008/2009,41,4,2008/2009,45,28,1,27,-Inf
2008/2009,41,5,2008/2009,46,22,2,20,-Inf
2008/2009,41,6,2008/2009,47,26,3,23,-Inf
2008/2009,41,7,2008/2009,48,24,4,20,-Inf
2008/2009,41,8,2008/2009,49,9,3,6,-Inf
2008/2009,41,9,2008/2009,50,21,1,20,-Inf
2008/2009,41,10,2008/2009,51,10,3,7,-11.512925464970229
2008/2009,41,11,2008/2009,52,15,5,10,-11.512925464970229
2008/2009,42,1,2008/2009,43,35,8,27,-Inf
2008/2009,42,2,2008/2009,44,28,5,23,-11.512925464970229
2008/2009,42,3,2008/2009,45,28,1,27,-Inf
2008/2009,42,4,2008/2009,46,22,2,20,-Inf
2008/2009,42,5,2008/2009,47,26,3,23,-Inf
2008/2009,42,6,2008/2009,48,24,4,20,-Inf
2008/2009,42,7,2008/2009,49,9,3,6,-Inf
2008/2009,42,8,2008/2009,50,21,1,20,-Inf
2008/2009,42,9,2008/2009,51,10,3,7,-Inf
2008/2009,42,10,2008/2009,52,15,5,10,-Inf
2008/2009,43,1,2008/2009,44,28,5,23,-Inf
2008/2009,43,2,2008/2009,45,28,1,27,-Inf
2008/2009,43,3,2008/2009,46,22,2,20,-Inf
2008/2009,43,4,2008/2009,47,26,3,23,-Inf
2008/2009,43,5,2008/2009,48,24,4,20,-11.512925464970229
2008/2009,43,6,2008/2009,49,9,3,6,-Inf
2008/2009,43,7,2008/2009,50,21,1,20,-Inf
2008/2009,43,8,2008/2009,51,10,3,7,-Inf
2008/2009,43,9,2008/2009,52,15,5,10,-Inf
2008/2009,44,1,2008/2009,45,28,1,27,-Inf
2008/2009,44,2,2008/2009,46,22,2,20,-Inf
2008/2009,44,3,2008/2009,47,26,3,23,-Inf
2008/2009,44,4,2008/2009,48,24,4,20,-Inf
2008/2009,44,5,2008/2009,49,9,3,6,-11.512925464970229
2008/2009,44,6,2008/2009,50,21,1,20,-10.819778284410283
2008/2009,44,7,2008/2009,51,10,3,7,-Inf
2008/2009,44,8,2008/2009,52,15,5,10,-Inf
2008/2009,45,1,2008/2009,46,22,2,20,-Inf
2008/2009,45,2,2008/2009,47,26,3,23,-11.512925464970229
2008/2009,45,3,2008/2009,48,24,4,20,-Inf
2008/2009,45,4,2008/2009,49,9,3,6,-Inf
2008/2009,45,5,2008/2009,50,21,1,20,-Inf
2008/2009,45,6,2008/2009,51,10,3,7,-Inf
2008/2009,45,7,2008/2009,52,15,5,10,-Inf
2008/2009,46,1,2008/2009,47,26,3,23,-Inf
2008/2009,46,2,2008/2009,48,24,4,20,-11.512925464970229
2008/2009,46,3,2008/2009,49,9,3,6,-Inf
2008/2009,46,4,2008/2009,50,21,1,20,-Inf
2008/2009,46,5,2008/2009,51,10,3,7,-Inf
2008/2009,46,6,2008/2009,52,15,5,10,-Inf
2008/2009,47,1,2008/2009,48,24,4,20,-Inf
2008/2009,47,2,2008/2009,49,9,3,6,-Inf
2008/2009,47,3,2008/2009,50,21,1,20,-Inf
2008/2009,47,4,2008/2009,51,10,3,7,-11.512925464970229
2008/2009,47,5,2008/2009,52,15,5,10,-11.512925464970229
2008/2009,48,1,2008/2009,49,9,3,6,-Inf
2008/2009,48,2,2008/2009,50,21,1,20,-Inf
2008/2009,48,3,2008/2009,51,10,3,7,-11.512925464970229
2008/2009,48,4,2008/2009,52,15,5,10,-Inf
2008/2009,49,1,2008/2009,50,21,1,20,-Inf
2008/2009,49,2,2008/2009,51,10,3,7,-Inf
2008/2009,49,3,2008/2009,52,15,5,10,-11.512925464970229
2008/2009,4,1,2008/2009,5,2,21,19,-Inf
2008/2009,4,2,2008/2009,6,2,18,16,-Inf
2008/2009,4,3,2008/2009,7,3,21,18,-11.512925464970229
2008/2009,4,4,2008/2009,8,4,34,30,-Inf
2008/2009,4,5,2008/2009,9,3,25,22,-Inf
2008/2009,4,6,2008/2009,10,4,34,30,-Inf
2008/2009,4,7,2008/2009,11,4,33,29,-Inf
2008/2009,4,8,2008/2009,12,4,40,36,-Inf
2008/2009,4,9,2008/2009,13,7,42,35,-Inf
2008/2009,4,10,2008/2009,14,6,36,30,-Inf
2008/2009,4,11,2008/2009,15,15,72,57,-Inf
2008/2009,4,12,2008/2009,16,11,75,64,-Inf
2008/2009,4,13,2008/2009,17,9,76,67,-Inf
2008/2009,4,14,2008/2009,18,9,92,83,-Inf
2008/2009,4,15,2008/2009,19,12,71,59,-Inf
2008/2009,4,16,2008/2009,20,13,112,99,-Inf
2008/2009,4,17,2008/2009,21,13,106,93,-Inf
2008/2009,4,18,2008/2009,22,13,101,88,-Inf
2008/2009,4,19,2008/2009,23,20,170,150,-Inf
2008/2009,4,20,2008/2009,24,28,135,107,-Inf
2008/2009,4,21,2008/2009,25,45,106,61,-11.512925464970229
2008/2009,4,22,2008/2009,26,28,68,40,-Inf
2008/2009,4,23,2008/2009,27,34,48,14,-Inf
2008/2009,4,24,2008/2009,28,41,48,7,-Inf
2008/2009,4,25,2008/2009,29,36,26,10,-Inf
2008/2009,4,26,2008/2009,30,38,33,5,-Inf
2008/2009,4,27,2008/2009,31,48,29,19,-Inf
2008/2009,4,28,2008/2009,32,27,17,10,-Inf
2008/2009,4,29,2008/2009,33,23,12,11,-Inf
2008/2009,4,30,2008/2009,34,28,13,15,-Inf
2008/2009,4,31,2008/2009,35,42,17,25,-Inf
2008/2009,4,32,2008/2009,36,30,15,15,-Inf
2008/2009,4,33,2008/2009,37,18,14,4,-Inf
2008/2009,4,34,2008/2009,38,38,15,23,-Inf
2008/2009,4,35,2008/2009,39,28,10,18,-Inf
2008/2009,4,36,2008/2009,40,36,9,27,-Inf
2008/2009,4,37,2008/2009,41,44,2,42,-Inf
2008/2009,4,38,2008/2009,42,41,6,35,-Inf
2008/2009,4,39,2008/2009,43,35,8,27,-Inf
2008/2009,4,40,2008/2009,44,28,5,23,-Inf
2008/2009,4,41,2008/2009,45,28,1,27,-Inf
2008/2009,4,42,2008/2009,46,22,2,20,-Inf
2008/2009,4,43,2008/2009,47,26,3,23,-Inf
2008/2009,4,44,2008/2009,48,24,4,20,-Inf
2008/2009,4,45,2008/2009,49,9,3,6,-Inf
2008/2009,4,46,2008/2009,50,21,1,20,-Inf
2008/2009,4,47,2008/2009,51,10,3,7,-Inf
2008/2009,4,48,2008/2009,52,15,5,10,-Inf
2008/2009,50,1,2008/2009,51,10,3,7,-Inf
2008/2009,50,2,2008/2009,52,15,5,10,-Inf
2008/2009,51,1,2008/2009,52,15,5,10,-11.512925464970229
2008/2009,5,1,2008/2009,6,2,18,16,-Inf
2008/2009,5,2,2008/2009,7,3,21,18,-Inf
2008/2009,5,3,2008/2009,8,4,34,30,-Inf
2008/2009,5,4,2008/2009,9,3,25,22,-Inf
2008/2009,5,5,2008/2009,10,4,34,30,-11.512925464970229
2008/2009,5,6,2008/2009,11,4,33,29,-Inf
2008/2009,5,7,2008/2009,12,4,40,36,-Inf
2008/2009,5,8,2008/2009,13,7,42,35,-Inf
2008/2009,5,9,2008/2009,14,6,36,30,-Inf
2008/2009,5,10,2008/2009,15,15,72,57,-Inf
2008/2009,5,11,2008/2009,16,11,75,64,-Inf
2008/2009,5,12,2008/2009,17,9,76,67,-Inf
2008/2009,5,13,2008/2009,18,9,92,83,-Inf
2008/2009,5,14,2008/2009,19,12,71,59,-Inf
2008/2009,5,15,2008/2009,20,13,112,99,-Inf
2008/2009,5,16,2008/2009,21,13,106,93,-Inf
2008/2009,5,17,2008/2009,22,13,101,88,-Inf
2008/2009,5,18,2008/2009,23,20,170,150,-Inf
2008/2009,5,19,2008/2009,24,28,135,107,-Inf
2008/2009,5,20,2008/2009,25,45,106,61,-Inf
2008/2009,5,21,2008/2009,26,28,68,40,-Inf
2008/2009,5,22,2008/2009,27,34,48,14,-Inf
2008/2009,5,23,2008/2009,28,41,48,7,-Inf
2008/2009,5,24,2008/2009,29,36,26,10,-Inf
2008/2009,5,25,2008/2009,30,38,33,5,-Inf
2008/2009,5,26,2008/2009,31,48,29,19,-Inf
2008/2009,5,27,2008/2009,32,27,17,10,-Inf
2008/2009,5,28,2008/2009,33,23,12,11,-Inf
2008/2009,5,29,2008/2009,34,28,13,15,-Inf
2008/2009,5,30,2008/2009,35,42,17,25,-Inf
2008/2009,5,31,2008/2009,36,30,15,15,-Inf
2008/2009,5,32,2008/2009,37,18,14,4,-Inf
2008/2009,5,33,2008/2009,38,38,15,23,-Inf
2008/2009,5,34,2008/2009,39,28,10,18,-Inf
2008/2009,5,35,2008/2009,40,36,9,27,-Inf
2008/2009,5,36,2008/2009,41,44,2,42,-Inf
2008/2009,5,37,2008/2009,42,41,6,35,-Inf
2008/2009,5,38,2008/2009,43,35,8,27,-11.512925464970229
2008/2009,5,39,2008/2009,44,28,5,23,-Inf
2008/2009,5,40,2008/2009,45,28,1,27,-Inf
2008/2009,5,41,2008/2009,46,22,2,20,-Inf
2008/2009,5,42,2008/2009,47,26,3,23,-Inf
2008/2009,5,43,2008/2009,48,24,4,20,-Inf
2008/2009,5,44,2008/2009,49,9,3,6,-Inf
2008/2009,5,45,2008/2009,50,21,1,20,-Inf
2008/2009,5,46,2008/2009,51,10,3,7,-Inf
2008/2009,5,47,2008/2009,52,15,5,10,-Inf
2008/2009,6,1,2008/2009,7,3,21,18,-Inf
2008/2009,6,2,2008/2009,8,4,34,30,-Inf
2008/2009,6,3,2008/2009,9,3,25,22,-Inf
2008/2009,6,4,2008/2009,10,4,34,30,-Inf
2008/2009,6,5,2008/2009,11,4,33,29,-Inf
2008/2009,6,6,2008/2009,12,4,40,36,-Inf
2008/2009,6,7,2008/2009,13,7,42,35,-Inf
2008/2009,6,8,2008/2009,14,6,36,30,-Inf
2008/2009,6,9,2008/2009,15,15,72,57,-Inf
2008/2009,6,10,2008/2009,16,11,75,64,-Inf
2008/2009,6,11,2008/2009,17,9,76,67,-Inf
2008/2009,6,12,2008/2009,18,9,92,83,-Inf
2008/2009,6,13,2008/2009,19,12,71,59,-Inf
2008/2009,6,14,2008/2009,20,13,112,99,-Inf
2008/2009,6,15,2008/2009,21,13,106,93,-Inf
2008/2009,6,16,2008/2009,22,13,101,88,-Inf
2008/2009,6,17,2008/2009,23,20,170,150,-Inf
2008/2009,6,18,2008/2009,24,28,135,107,-Inf
2008/2009,6,19,2008/2009,25,45,106,61,-Inf
2008/2009,6,20,2008/2009,26,28,68,40,-Inf
2008/2009,6,21,2008/2009,27,34,48,14,-Inf
2008/2009,6,22,2008/2009,28,41,48,7,-Inf
2008/2009,6,23,2008/2009,29,36,26,10,-Inf
2008/2009,6,24,2008/2009,30,38,33,5,-Inf
2008/2009,6,25,2008/2009,31,48,29,19,-Inf
2008/2009,6,26,2008/2009,32,27,17,10,-Inf
2008/2009,6,27,2008/2009,33,23,12,11,-Inf
2008/2009,6,28,2008/2009,34,28,13,15,-Inf
2008/2009,6,29,2008/2009,35,42,17,25,-Inf
2008/2009,6,30,2008/2009,36,30,15,15,-Inf
2008/2009,6,31,2008/2009,37,18,14,4,-Inf
2008/2009,6,32,2008/2009,38,38,15,23,-Inf
2008/2009,6,33,2008/2009,39,28,10,18,-Inf
2008/2009,6,34,2008/2009,40,36,9,27,-Inf
2008/2009,6,35,2008/2009,41,44,2,42,-Inf
2008/2009,6,36,2008/2009,42,41,6,35,-Inf
2008/2009,6,37,2008/2009,43,35,8,27,-Inf
2008/2009,6,38,2008/2009,44,28,5,23,-Inf
2008/2009,6,39,2008/2009,45,28,1,27,-Inf
2008/2009,6,40,2008/2009,46,22,2,20,-Inf
2008/2009,6,41,2008/2009,47,26,3,23,-Inf
2008/2009,6,42,2008/2009,48,24,4,20,-Inf
2008/2009,6,43,2008/2009,49,9,3,6,-Inf
2008/2009,6,44,2008/2009,50,21,1,20,-Inf
2008/2009,6,45,2008/2009,51,10,3,7,-Inf
2008/2009,6,46,2008/2009,52,15,5,10,-Inf
2008/2009,7,1,2008/2009,8,4,34,30,-Inf
2008/2009,7,2,2008/2009,9,3,25,22,-Inf
2008/2009,7,3,2008/2009,10,4,34,30,-11.512925464970229
2008/2009,7,4,2008/2009,11,4,33,29,-11.512925464970229
2008/2009,7,5,2008/2009,12,4,40,36,-Inf
2008/2009,7,6,2008/2009,13,7,42,35,-Inf
2008/2009,7,7,2008/2009,14,6,36,30,-Inf
2008/2009,7,8,2008/2009,15,15,72,57,-Inf
2008/2009,7,9,2008/2009,16,11,75,64,-Inf
2008/2009,7,10,2008/2009,17,9,76,67,-Inf
2008/2009,7,11,2008/2009,18,9,92,83,-Inf
2008/2009,7,12,2008/2009,19,12,71,59,-Inf
2008/2009,7,13,2008/2009,20,13,112,99,-Inf
2008/2009,7,14,2008/2009,21,13,106,93,-Inf
2008/2009,7,15,2008/2009,22,13,101,88,-Inf
2008/2009,7,16,2008/2009,23,20,170,150,-Inf
2008/2009,7,17,2008/2009,24,28,135,107,-Inf
2008/2009,7,18,2008/2009,25,45,106,61,-Inf
2008/2009,7,19,2008/2009,26,28,68,40,-Inf
2008/2009,7,20,2008/2009,27,34,48,14,-Inf
2008/2009,7,21,2008/2009,28,41,48,7,-Inf
2008/2009,7,22,2008/2009,29,36,26,10,-Inf
2008/2009,7,23,2008/2009,30,38,33,5,-Inf
2008/2009,7,24,2008/2009,31,48,29,19,-Inf
2008/2009,7,25,2008/2009,32,27,17,10,-Inf
2008/2009,7,26,2008/2009,33,23,12,11,-Inf
2008/2009,7,27,2008/2009,34,28,13,15,-Inf
2008/2009,7,28,2008/2009,35,42,17,25,-Inf
2008/2009,7,29,2008/2009,36,30,15,15,-Inf
2008/2009,7,30,2008/2009,37,18,14,4,-Inf
2008/2009,7,31,2008/2009,38,38,15,23,-Inf
2008/2009,7,32,2008/2009,39,28,10,18,-Inf
2008/2009,7,33,2008/2009,40,36,9,27,-Inf
2008/2009,7,34,2008/2009,41,44,2,42,-Inf
2008/2009,7,35,2008/2009,42,41,6,35,-Inf
2008/2009,7,36,2008/2009,43,35,8,27,-Inf
2008/2009,7,37,2008/2009,44,28,5,23,-Inf
2008/2009,7,38,2008/2009,45,28,1,27,-Inf
2008/2009,7,39,2008/2009,46,22,2,20,-Inf
2008/2009,7,40,2008/2009,47,26,3,23,-Inf
2008/2009,7,41,2008/2009,48,24,4,20,-Inf
2008/2009,7,42,2008/2009,49,9,3,6,-11.512925464970229
2008/2009,7,43,2008/2009,50,21,1,20,-Inf
2008/2009,7,44,2008/2009,51,10,3,7,-Inf
2008/2009,7,45,2008/2009,52,15,5,10,-Inf
2008/2009,8,1,2008/2009,9,3,25,22,-Inf
2008/2009,8,2,2008/2009,10,4,34,30,-Inf
2008/2009,8,3,2008/2009,11,4,33,29,-Inf
2008/2009,8,4,2008/2009,12,4,40,36,-11.512925464970229
2008/2009,8,5,2008/2009,13,7,42,35,-Inf
2008/2009,8,6,2008/2009,14,6,36,30,-Inf
2008/2009,8,7,2008/2009,15,15,72,57,-Inf
2008/2009,8,8,2008/2009,16,11,75,64,-Inf
2008/2009,8,9,2008/2009,17,9,76,67,-Inf
2008/2009,8,10,2008/2009,18,9,92,83,-Inf
2008/2009,8,11,2008/2009,19,12,71,59,-Inf
2008/2009,8,12,2008/2009,20,13,112,99,-Inf
2008/2009,8,13,2008/2009,21,13,106,93,-Inf
2008/2009,8,14,2008/2009,22,13,101,88,-Inf
2008/2009,8,15,2008/2009,23,20,170,150,-Inf
2008/2009,8,16,2008/2009,24,28,135,107,-Inf
2008/2009,8,17,2008/2009,25,45,106,61,-Inf
2008/2009,8,18,2008/2009,26,28,68,40,-Inf
2008/2009,8,19,2008/2009,27,34,48,14,-Inf
2008/2009,8,20,2008/2009,28,41,48,7,-Inf
2008/2009,8,21,2008/2009,29,36,26,10,-Inf
2008/2009,8,22,2008/2009,30,38,33,5,-Inf
2008/2009,8,23,2008/2009,31,48,29,19,-Inf
2008/2009,8,24,2008/2009,32,27,17,10,-Inf
2008/2009,8,25,2008/2009,33,23,12,11,-Inf
2008/2009,8,26,2008/2009,34,28,13,15,-Inf
2008/2009,8,27,2008/2009,35,42,17,25,-Inf
2008/2009,8,28,2008/2009,36,30,15,15,-Inf
2008/2009,8,29,2008/2009,37,18,14,4,-Inf
2008/2009,8,30,2008/2009,38,38,15,23,-Inf
2008/2009,8,31,2008/2009,39,28,10,18,-Inf
2008/2009,8,32,2008/2009,40,36,9,27,-Inf
2008/2009,8,33,2008/2009,41,44,2,42,-Inf
2008/2009,8,34,2008/2009,42,41,6,35,-Inf
2008/2009,8,35,2008/2009,43,35,8,27,-Inf
2008/2009,8,36,2008/2009,44,28,5,23,-Inf
2008/2009,8,37,2008/2009,45,28,1,27,-Inf
2008/2009,8,38,2008/2009,46,22,2,20,-Inf
2008/2009,8,39,2008/2009,47,26,3,23,-Inf
2008/2009,8,40,2008/2009,48,24,4,20,-Inf
2008/2009,8,41,2008/2009,49,9,3,6,-Inf
2008/2009,8,42,2008/2009,50,21,1,20,-Inf
2008/2009,8,43,2008/2009,51,10,3,7,-Inf
2008/2009,8,44,2008/2009,52,15,5,10,-Inf
2008/2009,9,1,2008/2009,10,4,34,30,-Inf
2008/2009,9,2,2008/2009,11,4,33,29,-Inf
2008/2009,9,3,2008/2009,12,4,40,36,-Inf
2008/2009,9,4,2008/2009,13,7,42,35,-Inf
2008/2009,9,5,2008/2009,14,6,36,30,-Inf
2008/2009,9,6,2008/2009,15,15,72,57,-Inf
2008/2009,9,7,2008/2009,16,11,75,64,-Inf
2008/2009,9,8,2008/2009,17,9,76,67,-Inf
2008/2009,9,9,2008/2009,18,9,92,83,-Inf
2008/2009,9,10,2008/2009,19,12,71,59,-Inf
2008/2009,9,11,2008/2009,20,13,112,99,-Inf
2008/2009,9,12,2008/2009,21,13,106,93,-Inf
2008/2009,9,13,2008/2009,22,13,101,88,-Inf
2008/2009,9,14,2008/2009,23,20,170,150,-Inf
2008/2009,9,15,2008/2009,24,28,135,107,-Inf
2008/2009,9,16,2008/2009,25,45,106,61,-Inf
2008/2009,9,17,2008/2009,26,28,68,40,-Inf
2008/2009,9,18,2008/2009,27,34,48,14,-Inf
2008/2009,9,19,2008/2009,28,41,48,7,-Inf
2008/2009,9,20,2008/2009,29,36,26,10,-Inf
2008/2009,9,21,2008/2009,30,38,33,5,-11.512925464970229
2008/2009,9,22,2008/2009,31,48,29,19,-Inf
2008/2009,9,23,2008/2009,32,27,17,10,-Inf
2008/2009,9,24,2008/2009,33,23,12,11,-Inf
2008/2009,9,25,2008/2009,34,28,13,15,-Inf
2008/2009,9,26,2008/2009,35,42,17,25,-Inf
2008/2009,9,27,2008/2009,36,30,15,15,-Inf
2008/2009,9,28,2008/2009,37,18,14,4,-Inf
2008/2009,9,29,2008/2009,38,38,15,23,-Inf
2008/2009,9,30,2008/2009,39,28,10,18,-Inf
2008/2009,9,31,2008/2009,40,36,9,27,-Inf
2008/2009,9,32,2008/2009,41,44,2,42,-Inf
2008/2009,9,33,2008/2009,42,41,6,35,-Inf
2008/2009,9,34,2008/2009,43,35,8,27,-Inf
2008/2009,9,35,2008/2009,44,28,5,23,-Inf
2008/2009,9,36,2008/2009,45,28,1,27,-Inf
2008/2009,9,37,2008/2009,46,22,2,20,-Inf
2008/2009,9,38,2008/2009,47,26,3,23,-Inf
2008/2009,9,39,2008/2009,48,24,4,20,-11.512925464970229
2008/2009,9,40,2008/2009,49,9,3,6,-Inf
2008/2009,9,41,2008/2009,50,21,1,20,-Inf
2008/2009,9,42,2008/2009,51,10,3,7,-11.512925464970229
2008/2009,9,43,2008/2009,52,15,5,10,-Inf
